border_size=1
usage=map

Rd          , Rd          , Rd          , Gs          , Gs          , Gs          , Gd^Fms      , Gs^Fms      , Wwrt        , Gs          , Gs          , Gs          , Gs          , Gs^Efm      , Gs          , Gs          , Gs          , Gs^Efm      , Gs^Fms      , Hh^Fms      , Mm          , Mm          , Mm          , Mm          , Rd          , Co          , Co          , Chr         , Chr         , Chr         , Chr         , Chr         
Rd          , Rd          , Rd          , Gs          , Gs          , Gs          , Gs^Fms      , Gs^Fms      , Wwt         , Gs^Efm      , Gs          , Gs          , Gs          , Gs          , Gs          , Gs          , Gs          , Gs          , Gs^Fms      , Hh^Fms      , Mm          , Mm          , Mm          , Mm          , Rd          , Co          , Co          , Chr         , Chr         , Chr         , Chr         , Chr         
Gs          , Gd          , Gs          , Rd          , Gs          , Gs          , Gs^Fms      , Dd          , Wwt         , Dd          , Dd          , Dd          , Gd          , Gd          , Gd          , Gd          , Gd          , Gs          , Gd^Fms      , Hh          , Mm          , Mm^Vhh      , Mm          , Mm          , Rd          , Rd          , Rd          , Co          , Co          , Chr         , Chr         , Chr         
Gs          , Gs          , Gs          , Rd          , Rd          , Gs^Fms      , Dd          , Dd          , Wwrt        , Wwt         , Wwt         , Dd          , Dd          , Dd          , Dd          , Dd          , Dd          , Gd          , Gd          , Hh          , Hh          , Mm          , Hh          , Mm          , Rd          , Gd^Fms      , Gs^Fms      , Gs          , Gs          , Co          , Co          , Co          
Gd^Fms      , Gs^Fms      , Gs^Fms      , Gs^Fms      , Gd^Fms      , Rd          , Rd          , Dd          , Dd          , Dd^Vdt      , Dd          , Wwt         , Wwt         , Wwt         , Wwt         , Wwt         , Wwt         , Dd          , Gd          , Gs          , Gd          , Hh          , Rd          , Rd          , Gs^Fms      , Gs^Fms      , Mm          , Mm^Vhh      , Mm          , Gs          , Gs          , Gs          
Gs          , Gs          , Gs^Fms      , Gs          , Rd          , Rd          , Gs          , Rd          , Dd          , Dd          , Dd          , Dd          , Dd          , Wwt         , Wwt         , Wwt         , Wwt         , Dd          , Gd^Efm      , Gs          , Gd          , Gd^Efm      , Rd          , Gd^Fms      , Hh^Fp       , Mm          , Mm^Vhh      , Mm          , Mm          , Gs^Fms      , Gs^Fms      , Gs^Fms      
Gs          , Gs          , Gs          , Gs^Fms      , Rd          , Gs^Efm      , Gs          , Rd          , Rd          , Rd          , Rd          , Rd          , Dd          , Dd          , Wwt         , Wwt         , Wwt         , Dd          , Dd          , Dd          , Dd          , Gd          , Rd          , Gs^Fms      , Hh          , Mm          , Mm          , Mm          , Mm          , Mm          , Hh          , Hh          
Gs          , Gs          , Gs          , Gs^Fms      , Rd          , Gs          , Gs          , Gs          , Gs          , Gs^Efm      , Gs          , Rd          , Dd          , Dd          , Wwt         , Wwt         , Wwrt        , Dd          , Dd          , Dd          , Dd          , Rd          , Gs          , Gd^Fms      , Hh^Fp       , Mm          , Hh^Fms      , Mm          , Hh^Fms      , Mm          , Ww          , Ww          
Gs          , Gs          , Gs          , Rd          , Gg          , Gs^Fms      , Gs          , Gd          , Gd          , Gs          , Gs          , Rd          , Rd          , Dd          , Dd          , Dd          , Dd          , Dd          , Dd          , Dd          , Gs^Fms      , Rd          , Gs          , Gs^Fms      , Gs^Fms      , Gs^Fms      , Hh^Fms      , Hh          , Hh          , Ww          , Ww          , Ww          
Gs          , Gs          , Gs          , Rd          , Gs^Fms      , Gs^Fms      , Gs          , Gd          , Gs          , Gs          , Gs          , Gs^Fms      , Gs          , Rd          , Dd          , Dd          , Dd          , Dd          , Gd^Fms      , Gd^Fms      , Rd          , Rd          , Gs^Fms      , Gd^Fms      , Gs^Fms      , Gs^Fms      , Gs^Fms      , Hh          , Hh          , Hh          , Ww          , Ww          
Gs^Fms      , Gs^Fms      , Gs          , Rd          , Gs^Fms      , Gs^Efm      , Gs          , Gs          , Gs^Efm      , Gs          , Gs          , Gs          , Gs          , Rd          , Rd          , Rd          , Rd          , Gd^Fms      , Gs^Fms      , Rd          , Gs^Fms      , Gd^Fms      , Gs^Fms      , Gs^Fms      , Gs^Fms      , Gs^Fms      , Gs^Fms      , Gs          , Hh^Fms      , Hh          , Hh          , Hh^Fp       
Gs^Fms      , Gs^Fms      , Gs^Fms      , Rd          , Rd          , Gs^Fms      , Gs          , Gs          , Gs          , Gs          , Gs          , Gs          , Gs          , Gs^Efm      , Gs          , Gs          , Gs          , Rd          , Rd          , Rd          , Gs          , Gd^Fms      , Gs^Fms      , Gs^Fms      , Gs^Fms      , Gs          , Gs^Fms      , Gs^Fms      , Gs^Fms      , Gs          , Gs          , Gs          
Gs          , Gs^Efm      , Gs^Fms      , Gs^Fms      , Rd          , Gs          , Gs          , Gs          , Gd          , Gd          , Gd          , Gs          , Gs          , Gs          , Gs          , Gs          , Gs          , Gs          , Gs          , Gs          , Gs          , Gs          , Gs^Fms      , Gs^Fms      , Gs          , Gs^Fms      , Gs^Fms      , Gs^Fms      , Gs          , Gs^Fms      , Gs^Fms      , Gs^Fms      
Gs          , Gs          , Gs          , Gs          , Gd^Fms      , Rd          , Rd          , Gs          , Gs          , Gd          , Gs          , Gs          , Gg^Efm      , Gs^Fms      , Gs^Fms      , Gd^Fms      , Gd^Fms      , Gs^Fms      , Gs          , Gs          , Gs          , Gs          , Gs          , Gs^Fms      , Gs^Fms      , Gs^Fms      , Gs          , Gd          , Gd^Fms      , Gs          , Gs^Fms      , Gs^Fms      
Gd          , Gd          , Gd          , Gs          , Gs          , Gd^Fms      , Rd          , Gs          , Gs          , Gs          , Gs          , Hh          , Hh          , Hh^Fms      , Gd          , Gd^Efm      , Ss          , Gs^Fms      , Gs          , Gs          , Gs          , Gs          , Gs          , Gs          , Gs^Fms      , Gs          , Gd          , Gd          , Gs          , Gs          , Hh^Fp       , Hh^Fp       
Gd          , Gd          , Gd          , Gs          , Gs          , Gs          , Rd          , Gs^Fms      , Hh^Fms      , Gs          , Hh          , Hh          , Hh^Vhh      , Hh          , Hh^Fms      , Gd          , Ss          , Gs^Fms      , Ds          , Gd          , Ds          , Ds          , Gd          , Gs          , Gs          , Gs          , Gs          , Gs          , Gs          , Hh          , Mm          , Mm          
Gs          , Gs          , Gs          , Gd          , Gs          , Gs          , Gs^Fms      , Rd          , Hh^Fms      , Hh          , Hh^Fms      , Hh          , Hh          , Hh          , Hh          , Ss          , Ss          , Ds          , Ds          , Ds          , Ds          , Ds          , Ds          , Gs          , Gs          , Gs          , Gs          , Gs          , Hh          , Mm          , Mm          , Mm          
Gs          , Gs          , Gs          , Gs          , Gs          , Gs^Fms      , Gs^Fms      , Rd          , Gs^Fms      , Gs^Fms      , Hh          , Hh          , Hh          , Hh^Fms      , Gs^Fms      , Gs^Fms      , Gs^Fms      , Gs^Fms      , Gs          , Ds          , Ds          , Ds          , Ds          , Ds          , Ds          , Gs^Fms      , Gd^Fms      , Gs          , Hh^Fms      , Mm          , Ww          , Ww          
Gd^Fms      , Gs^Fms      , Gs          , Gs          , Gs          , Gs          , Gs          , Rd          , Gs^Fms      , Gs^Fms      , Gs^Fms      , Hh^Fms      , Gs^Fms      , Gs^Fms      , Gs^Efm      , Gs^Fms      , Gs^Fms      , Gs^Efm      , Gs          , Gs          , Hh          , Gd^Fms      , Hh^Fms      , Gd^Fms      , Ds          , Gs^Fms      , Gd^Fms      , Hh^Fms      , Hh          , Ww          , Ww          , Ww          
Gd^Fms      , Gs^Fms      , Gs          , Gs          , Gs          , Gs          , Gs          , Rd          , Rd          , Gs^Fms      , Rd          , Gs^Fms      , Rd          , Gs^Fms      , Gs^Fms      , Gs^Fms      , Gs^Fms      , Gs          , Gs          , Gs          , Mm          , Mm^Vhh      , Mm          , Hh          , Gd^Fms      , Gs^Fms      , Gs^Fms      , Hh^Fms      , Hh^Fms      , Mm          , Ww          , Ww          
Gs^Fms      , Gs^Fms      , Gs          , Gs          , Gs          , Gd^Efm      , Gs          , Gs          , Gs^Fms      , Rd          , Gs^Fms      , Rd          , Gs^Fms      , Rd          , Gs^Fms      , Gs^Fms      , Gs^Fms      , Gs          , Gs^Fms      , Hh          , Mm          , Mm          , Mm          , Mm          , Gd          , Gs          , Gs^Fms      , Gs^Fms      , Hh^Fms      , Hh^Fms      , Hh          , Hh          
Gs          , Gs          , Gs^Fms      , Gs          , Gs          , Gs          , Gs          , Gs          , Gs^Fms      , Gs^Fms      , Gd          , Gs^Fms      , Gs^Fms      , Rd          , Rd          , Rd          , Rd          , Gs^Fms      , Gs^Fms      , Gs^Fms      , Hh^Fp       , Mm          , Hh          , Gd          , Gs          , Ds          , Gs^Fms      , Gs^Fms      , Gs^Fms      , Gs          , Gs          , Gs          
Gd          , Gs          , Gs          , Gs^Fms      , Gs          , Gs          , Gs          , Gs          , Gs^Fms      , Wwrt        , Wwt         , Wwrt        , Gs^Fms      , Gs^Fms      , Gs^Efm      , Gs^Fms      , Rd          , Gs^Fms      , Rd          , Gs^Fms      , Gs^Fms      , Gs^Fms      , Gd          , Gd          , Gd          , Ds          , Gs^Fms      , Gs^Fms      , Gs          , Gs          , Gs          , Gs          
Gd          , Gd          , Gs          , Gs          , Gs^Fms      , Gs          , Gs          , Gs^Fms      , Wwt         , Wwt         , Wwt         , Wwt         , Wwt         , Gs^Fms      , Gs^Fms      , Gs^Fms      , Gs^Fms      , Rd          , Gs^Fms      , Rd          , Gs^Fms      , Gs^Fms      , Gs^Fms      , Gd          , Gd          , Gd^Fms      , Ds          , Ss          , Ss          , Ss          , Ss          , Ss          
Gs          , Gs          , Gs^Fms      , Gs          , Gs          , Gs          , Gs^Fms      , Gs^Fms      , Wwt         , Wwt         , Wwt         , Wwt         , Wwt         , Wwt         , Gs^Fms      , Gs^Fms      , Ss          , Gs^Fms      , Gs^Fms      , Rd          , Rd          , Gd^Fms      , Gd^Fms      , Gd^Fms      , Gd^Fms      , Gs^Fms      , Gs^Fms      , Ss          , Gs          , Gs          , Ss          , Ss          
Gs          , Gs          , Gs          , Gs          , Gs          , Gs          , Gd          , Wwt         , Wwt         , Wwt         , Wwrt        , Wwt         , Wwt         , Wwt         , Wwt         , Ss          , Ss          , Ss          , Gs^Fms      , Gs^Fms      , Rd          , Gd          , Rd          , Gs^Fms      , Rd          , Gs^Fms      , Rd          , Gs^Fms      , Gs^Fms      , Gs          , Ss          , Ss          
Gd          , Gs          , Ds          , Gs          , Gs          , Gd          , Gd          , Wwt         , Wwt         , Wwt         , Wwt         , Wwt         , Wwt         , Wwt         , Gs^Efm      , Wwrt        , Gs^Fp       , Ss          , Gs^Fms      , Gs^Fms      , Gs^Fms      , Rd          , Gs^Fms      , Rd          , Gs^Fms      , Rd          , Gs^Fms      , Rd          , Gs^Fms      , Gs^Fms      , Gs^Fms      , Gs^Fms      
Ds          , Ds          , Ds          , Gs          , Gs          , Gs          , Gs^Fms      , Wwt         , Gd^Fms      , Wwt         , Wwt         , Wwt         , Wwt         , Gs          , Gs          , Wwt         , Wwt         , Ss          , Gs^Fms      , Gs          , Gs^Fms      , Gs^Fms      , Gs^Efm      , Gs^Fms      , Gs^Efm      , Gs^Fms      , Gs^Fms      , Rd          , Gs^Fms      , Gs^Fms      , Gs^Fms      , Gs^Fms      
Ds          , Ds          , Ds          , Ds          , Gd^Fms      , Gs^Fms      , Gs^Efm      , Gs^Fms      , Gd^Efm      , Wwt         , Wwt         , Wwt         , Wwt         , Gs^Fms      , Gs          , Gd          , Ss          , Wwt         , Gs^Fms      , Gs^Efm      , Gs^Fms      , Gs^Fms      , Gs^Fms      , Gs          , Gs^Fms      , Gs^Fms      , Gs^Fms      , Rd          , Gd^Fms      , Gs^Efm      , Gs^Fms      , Gs^Fms      
Wwt         , Wwrt        , Ds^Vct      , Ds          , Ds          , Ds          , Ds          , Gs^Fms      , Gs^Fms      , Gs^Fms      , Gs^Fms      , Gd^Fms      , Wwrt        , Gs^Fms      , Gs^Efm      , Ss          , Ds          , Wwt         , Gs^Fms      , Gs^Fms      , Gs^Fms      , Gs^Fms      , Gs^Fms      , Gs^Fms      , Gs^Fms      , Gs^Fms      , Gs          , Rd          , Gd          , Gd^Fms      , Ds          , Ds          
Wot         , Wwt         , Wwt         , Ds          , Ds          , Ds          , Ds          , Ds          , Gs^Fms      , Gs^Efm      , Ds          , Gs^Fms      , Gs^Fms      , Gs^Fms      , Ss          , Ss          , Ds          , Wwrt        , Wwt         , Wwt         , Wwt         , Ds          , Ds          , Ds          , Gd^Fms      , Gs^Efm      , Gd^Fms      , Rd          , Gs^Fms      , Gd^Fms      , Ds          , Ds          
Wot         , Wot         , Wot         , Wwt         , Wwt         , Wwt         , Wwt         , Wwrt        , Ds          , Ds          , Ds          , Ds          , Gd^Fms      , Gs^Efm      , Gs          , Gd^Fms      , Ds          , Ds          , Wwt         , Wot         , Wot         , Wwt         , Wwt         , Wwrt        , Ds          , Gd^Efm      , Gd          , Rd          , Rd          , Gs^Fms      , Ds          , Ds          
Wot         , Wot         , Wot         , Wot         , Wot         , Wot         , Wot         , Wwt         , Wwt         , Wwt         , Wwt         , Ds          , Ds          , Ds          , Ds          , Ds          , Ds          , Ds          , Wwt         , Wot         , Wot         , Wot         , Wot         , Wwt         , Wwt         , Ds          , Ds          , Ds          , Ds          , Ds          , Wwt         , Wwrt        
Wot         , Wot         , Wot         , Wot         , Wot         , Wot         , Wot         , Wot         , Wot         , Wot         , Wot         , Wwt         , Ds          , Ds          , Ds          , Ds          , Ds          , Wwt         , Wot         , Wot         , Wot         , Wot         , Wot         , Wot         , Wot         , Wwt         , Wwt         , Wwt         , Wwt         , Wwt         , Wot         , Wot         
Wot         , Wot         , Wot         , Wot         , Wot         , Wot         , Wot         , Wot         , Wot         , Wot         , Wot         , Wwt         , Wwt         , Wwt         , Wwt         , Wwt         , Wwt         , Wwt         , Wot         , Wot         , Wot         , Wot         , Wot         , Wot         , Wot         , Wot         , Wot         , Wot         , Wot         , Wot         , Wot         , Wot         
Wot         , Wot         , Wot         , Wot         , Wot         , Wot         , Wot         , Wot         , Wot         , Wot         , Wot         , Wot         , Wot         , Wot         , Wot         , Wot         , Wot         , Wot         , Wot         , Wot         , Wot         , Wot         , Wot         , Wot         , Wot         , Wot         , Wot         , Wot         , Wot         , Wot         , Wot         , Wot         
Wot         , Wot         , Wot         , Wot         , Wot         , Wot         , Wot         , Wot         , Wot         , Wot         , Wot         , Wot         , Wot         , Wot         , Wot         , Wot         , Wot         , Wot         , Wot         , Wot         , Wot         , Wot         , Wot         , Wot         , Wot         , Wot         , Wot         , Wot         , Wot         , Wot         , Wot         , Wot         
Wot         , Wot         , Wot         , Wot         , Wot         , Wot         , Wot         , Wot         , Wot         , Wot         , Wot         , Wot         , Wot         , Wot         , Wot         , Wot         , Wot         , Wot         , Wot         , Wot         , Wot         , Wot         , Wot         , Wot         , Wot         , Wot         , Wot         , Wot         , Wot         , Wot         , Wot         , Wot         
Wot         , Wot         , Wot         , Wot         , Wot         , Wot         , Wot         , Wot         , Wot         , Wot         , Wot         , Wot         , Wot         , Wot         , Wot         , Wot         , Wot         , Wot         , Wot         , Wot         , Wot         , Wot         , Wot         , Wot         , Wot         , Wot         , Wot         , Wot         , Wot         , Wot         , Wot         , Wot         
Wot         , Wot         , Wot         , Wot         , Wot         , Wot         , Wot         , Wot         , Wot         , Wot         , Wot         , Wot         , Wot         , Wot         , Wot         , Wot         , Wot         , Wot         , Wot         , Wot         , Wot         , Wot         , Wot         , Wot         , Wot         , Wot         , Wot         , Wot         , Wot         , Wot         , Wot         , Wot         
Wot         , Wot         , Wot         , Wot         , Wot         , Wot         , Wot         , Wot         , Wot         , Wot         , Wot         , Wot         , Wot         , Wot         , Wot         , Wot         , Wot         , Wot         , Wot         , Wot         , Wot         , Wot         , Wot         , Wot         , Wot         , Wot         , Wot         , Wot         , Wot         , Wot         , Wot         , Wot         
Wot         , Wot         , Wot         , Wot         , Wot         , Wot         , Wot         , Wot         , Wot         , Wot         , Wot         , Wot         , Wot         , Wot         , Wot         , Wot         , Wot         , Wot         , Wot         , Wot         , Wot         , Wot         , Wot         , Wot         , Wot         , Wot         , Wot         , Wot         , Wot         , Wot         , Wot         , Wot         
Wot         , Wot         , Wot         , Wot         , Wot         , Wot         , Wot         , Wot         , Wot         , Wot         , Wot         , Wot         , Wot         , Wot         , Wot         , Wot         , Wot         , Wot         , Wot         , Wot         , Wot         , Wot         , Wot         , Wot         , Wot         , Wot         , Wot         , Wot         , Wot         , Wot         , Wot         , Wot         
Wot         , Wot         , Wot         , Wot         , Wot         , Wot         , Wot         , Wot         , Wot         , Wot         , Wot         , Wot         , Wot         , Wot         , Wot         , Wot         , Wot         , Wot         , Wot         , Wot         , Wot         , Wot         , Wot         , Wot         , Wot         , Wot         , Wot         , Wot         , Wot         , Wot         , Wot         , Wot         
Wot         , Wot         , Wot         , Wot         , Wot         , Wot         , Wot         , Wot         , Wot         , Wot         , Wot         , Wot         , Wot         , Wot         , Wot         , Wot         , Wot         , Wot         , Wot         , Wot         , Wot         , Wot         , Wot         , Wot         , Wot         , Wot         , Wot         , Wot         , Wot         , Wot         , Wot         , Wot         
Wot         , Wot         , Wot         , Wot         , Wot         , Wot         , Wot         , Wot         , Wot         , Wot         , Wot         , Wot         , Wot         , Wot         , Wot         , Wot         , Wot         , Wot         , Wot         , Wot         , Wot         , Wot         , Wot         , Wot         , Wot         , Wot         , Wot         , Wot         , Wot         , Wot         , Wot         , Wot         
Wot         , Wot         , Wot         , Wot         , Wot         , Wot         , Wot         , Wot         , Wot         , Wot         , Wot         , Wot         , Wot         , Wot         , Wot         , Wot         , Wot         , Wot         , Wot         , Wot         , Wot         , Wot         , Wot         , Wot         , Wot         , Wot         , Wot         , Wot         , Wot         , Wot         , Wot         , Wot         
Wot         , Wot         , Wot         , Wot         , Wot         , Wot         , Wot         , Wot         , Wot         , Wot         , Wot         , Wot         , Wot         , Wot         , Wot         , Wot         , Wot         , Wot         , Wot         , Wot         , Wot         , Wot         , Wot         , Wot         , Wot         , Wot         , Wot         , Wot         , Wot         , Wot         , Wot         , Wot         
Wot         , Wot         , Wot         , Wot         , Wot         , Wot         , Wot         , Wot         , Wot         , Wot         , Wot         , Wot         , Wot         , Wot         , Wot         , Wot         , Wot         , Wot         , Wot         , Wot         , Wot         , Wot         , Wot         , Wot         , Wot         , Wot         , Wot         , Wot         , Wot         , Wot         , Wot         , Wot         
Wot         , Wot         , Wot         , Wot         , Wot         , Wot         , Wot         , Wot         , Wot         , Wot         , Wot         , Wot         , Wot         , Wot         , Wot         , Wot         , Wot         , Wot         , Wot         , Wot         , Wot         , Wot         , Wot         , Wot         , Wot         , Wot         , Wot         , Wot         , Wot         , Wot         , Wot         , Wot         
Wot         , Wot         , Wot         , Wot         , Wot         , Wot         , Wot         , Wot         , Wot         , Wot         , Wot         , Wot         , Wot         , Wot         , Wot         , Wot         , Wot         , Wot         , Wot         , Wot         , Wot         , Wot         , Wot         , Wot         , Wot         , Wot         , Wot         , Wot         , Wot         , Wot         , Wot         , Wot         
Wot         , Wot         , Wot         , Wot         , Wot         , Wot         , Wot         , Wot         , Wot         , Wot         , Wot         , Wot         , Wot         , Wot         , Wot         , Wot         , Wot         , Wot         , Wot         , Wot         , Wot         , Wot         , Wot         , Wot         , Wot         , Wot         , Wot         , Wot         , Wot         , Wot         , Wot         , Wot         
Wot         , Wot         , Wot         , Wot         , Wot         , Wot         , Wot         , Wot         , Wot         , Wot         , Wot         , Wot         , Wot         , Wot         , Wot         , Wot         , Ww^Vm       , Wot         , Wot         , Wot         , Wot         , Wot         , Wot         , Wot         , Wot         , Wot         , Wot         , Wot         , Wot         , Wot         , Wot         , Wot         
Wot         , Wot         , Wot         , Wot         , Wot         , Wot         , Wot         , Wot         , Wot         , Wot         , Wot         , Wot         , Wot         , Wot         , Wot         , Wot         , Wot         , Wot         , Wot         , Wot         , Wot         , Wot         , Wot         , Wot         , Wot         , Wot         , Wot         , Wot         , Wot         , Wot         , Wot         , Wot         
Wot         , Wot         , Wot         , Wot         , Wot         , Wot         , Wot         , Wot         , Wot         , Wot         , Wot         , Wot         , Wot         , Wot         , Wot         , Wot         , Wot         , Wot         , Wot         , Wot         , Wot         , Wot         , Wot         , Wot         , Wot         , Wot         , Wot         , Wot         , Wot         , Wot         , Wot         , Wot         
Wot         , Wot         , Wot         , Wot         , Wot         , Wot         , Wot         , Wot         , Wot         , Wot         , Wot         , Wot         , Wot         , Wot         , Wot         , Wot         , Wot         , Wot         , Wot         , Wot         , Wot         , Wot         , Wot         , Wot         , Wot         , Wot         , Wot         , Wot         , Wot         , Wot         , Wot         , Wot         
Wot         , Wot         , Wot         , Wot         , Wot         , Wot         , Wot         , Wot         , Wot         , Wot         , Wot         , Wot         , Wot         , Wot         , Wot         , Wot         , Wot         , Wot         , Wot         , Wot         , Wot         , Wot         , Wot         , Wot         , Wot         , Wot         , Wot         , Wot         , Wot         , Wot         , Wot         , Wot         
