border_size=1
usage=map

Md^Xm       , Md^Xm       , Md^Xm       , Md^Xm       , Md          , Md          , Md          , Qlf         , Qlf         , Qlf         , Qlf         , Qlf         , Qlf         , Qlf         , Qlf         , Md^Xm       , Md^Xm       , Md          , Md          , Md^Xm       , Md^Xm       , Md^Xm       
Md^Xm       , Md^Xm       , Md          , Md          , Md          , Md          , Md          , Qlf         , Gd          , Qlf         , Gd          , Qlf         , Gd          , Gd          , Qlf         , Md          , Md          , Md          , Md          , Md          , Mv          , Md^Xm       
Md          , Mv          , Md          , Md          , Md          , Md          , Gd          , Gd          , Gs          , Gd          , Gd          , Gd          , Gd          , Gd          , Gd          , Qlf         , Md          , Md          , Md          , Md          , Md          , Md^Xm       
Mm^Xm       , Md          , Md^Xm       , Hh          , Gd          , Gd          , Gs          , Gs          , Gs          , Gd          , Gs          , Gs          , Gd          , Gs          , Gs          , Md          , Md          , Md          , Md          , Md          , Md          , Md^Xm       
Md          , Md          , Md          , Md          , Md          , Gd          , Gd          , Gd          , Gd          , Gd          , Gd          , Gd          , Gs          , Gd          , Gs          , Hh          , Hh          , Md          , Md^Xm       , Md^Xm       , Md^Xm       , Md^Xm       
Md^Xm       , Md^Xm       , Md          , Md          , Md          , Hh          , Gd          , Gs          , Gs          , Gs          , Gd          , Gd          , Gd          , Gs          , Gs          , Gd          , Md          , Md          , Md          , Md^Xm       , Md^Xm       , Md^Xm       
Md^Xm       , Md^Xm       , Md^Xm       , Md          , Hh          , Hh          , Gd          , Gd          , Gd          , Gd          , Gd          , Gs          , Gs          , Gd          , Md          , Md          , Md          , Md          , Md^Xm       , Md          , Md          , Md^Xm       
Md^Xm       , Md^Xm       , Md          , Md          , Md          , Gd          , Gs^Efm      , Gs          , Gs          , Gs          , Gd^Efm      , Gd          , Gd^Efm      , Gd^Efm      , Gd^Efm      , Md          , Md          , Md          , Md          , Md^Xm       , Md^Xm       , Md^Xm       
Md          , Md          , Md          , Md          , Md          , Gd^Efm      , Gd^Efm      , Gs^Efm      , Gs^Efm      , Gs^Efm      , Gs^Efm      , Gs^Efm      , Gs^Efm      , Gs^Efm      , Gs^Efm      , Md          , Md          , Md          , Md          , Md^Xm       , Md^Xm       , Md^Xm       
Md^Xm       , Md          , Md          , Md          , Md          , Gd^Efm      , Ww          , Gs^Efm      , Ww          , Gs^Efm      , Gs^Efm      , Gs^Efm      , Gs^Efm      , Gs^Efm      , Md          , Md          , Md          , Md          , Md          , Md          , Md^Xm       , Md^Xm       
Md^Xm       , Mv          , Md          , Md          , Md          , Wwr         , Ww          , Ww          , Ww          , Ww          , Ww          , Ww          , Ww          , Ww          , Md          , Md          , Md          , Md          , Md          , Md^Xm       , Md          , Md^Xm       
Md^Xm       , Md^Xm       , Md          , Md          , Wwg         , Ww          , Ww          , Ww          , Ww          , Ww          , Ww          , Ww          , Ww          , Ww          , Md          , Md          , Md          , Md          , Md          , Md          , Md^Xm       , Md          
Md^Xm       , Md^Xm       , Md          , Hh          , Ww          , Ww          , Wwr         , Wwr         , Wwr         , Wwr         , Wwr         , Ww          , Ww          , Ww          , Hh          , Md          , Md          , Md          , Md          , Md^Xm       , Md          , Md^Xm       
Md^Xm       , Md^Xm       , Md^Xm       , Md          , Ww          , Ww          , Ww          , Wwr         , Ww          , Ww          , Wwr         , Wwr         , Ww          , Hh          , Hh          , Md          , Md          , Md          , Md          , Md          , Md          , Md          
Md          , Md          , Md          , Md          , Ww          , Ww          , Ww          , Ww          , Ww          , Ww          , Ww          , Ww          , Ww          , Ww          , Md          , Md          , Md          , Md          , Md          , Md          , Md^Xm       , Md^Xm       
Md^Xm       , Mv          , Md          , Md          , Ww          , Ww          , Ww          , Ww          , Gs^Efm      , Ww          , Ww          , Ww          , Ww          , Ww          , Wwr         , Md          , Md          , Md          , Md          , Md^Xm       , Md^Xm       , Md^Xm       
Md^Xm       , Md^Xm       , Hh          , Wwr         , Gs^Efm      , Gs^Efm      , Gs^Efm      , Gs^Efm      , Gs^Efm      , Gs^Efm      , Gs^Efm      , Ww          , Gs^Efm      , Ww          , Gs^Efm      , Md          , Md          , Md          , Md          , Md          , Md^Xm       , Md^Xm       
Md          , Md          , Md          , Gs^Efm      , Gs^Efm      , Gs^Efm      , Gs          , Gs^Efm      , Gs          , Gs^Efm      , Gs^Efm      , Gs^Efm      , Gs^Efm      , Gs^Efm      , Gs^Efm      , Gs^Efm      , Hh          , Md          , Md^Xm       , Md^Xm       , Md^Xm       , Md^Xm       
Mm^Xm       , Md          , Md          , Gs          , Gs          , Gs          , Gs          , Gs          , Gs          , Gs          , Gs          , Gs^Efm      , Gs          , Gs          , Gs          , Md          , Md          , Md          , Mv          , Md^Xm       , Md^Xm       , Md^Xm       
Md          , Md          , Md          , Md          , Gs          , Gs          , Gs          , Gs          , Gs          , Gs          , Gs          , Gs          , Gs          , Gs          , Gs          , Md          , Md          , Md          , Md          , Md^Xm       , Md^Xm       , Md^Xm       
Md          , Hh          , Hh          , Gs          , Gs          , Gs          , Gs          , Gs          , Gs          , Gs          , Gs          , Gs          , Gs          , Gs          , Gs          , Gs          , Hh          , Md          , Md          , Md^Xm       , Md^Xm       , Md^Xm       
Mm^Xm       , Md          , Md          , Gs          , Gs          , Gs          , Gs          , Gs          , Gs          , Gs          , Gs          , Gs          , Gs          , Gs          , Gs          , Gs          , Md^Xm       , Md^Xm       , Md^Xm       , Md^Xm       , Md^Xm       , Md^Xm       
