border_size=1
usage=map

Wot         , Wot         , Wot         , Wot         , Wot         , Wot         , Wot         , Wot         , Wot         , Wot         , Wot         , Wot         , Wot         , Wot         , Wot         , Wot         , Wot         , Wot         , Wot         , Wot         , Wot         , Wot         , Wot         , Wot         , Wot         , Wot         , Wot         , Wot         , Wot         , Wot         , Wot         , Wot         
Wot         , Wot         , Wot         , Wot         , Wot         , Wot         , Wot         , Wot         , Wot         , Wot         , Wot         , Wot         , Wot         , Wot         , Wwr         , Wot         , Wot         , Wot         , Wot         , Wot         , Wot         , Wot         , Wot         , Wot         , Wot         , Wot         , Wot         , Wot         , Wot         , Wot         , Wot         , Wot         
Wot         , Wot         , Wot         , Wot         , Wot         , Wot         , Wot         , Wot         , Wot         , Wot         , Wot         , Wot         , Xuce        , Xuce        , Ds          , Ds          , Ds          , Wot         , Ds          , Wot         , Wot         , Wot         , Wot         , Wot         , Wot         , Wot         , Wot         , Wot         , Wot         , Wot         , Wot         , Wot         
Wot         , Wot         , Wot         , Wot         , Wot         , Wot         , Wot         , Wot         , Wot         , Wot         , Xuce        , Xuce        , Xuce        , Xuce        , Xuce        , Ds          , Rd          , Ds          , Ds          , Xuce        , Xuce        , Wot         , Wot         , Wot         , Wot         , Wot         , Wot         , Wot         , Wot         , Wot         , Wot         , Wot         
Wot         , Wot         , Wot         , Wot         , Wot         , Wot         , Xuce        , Xuce        , Xuce        , Xuce        , Xuce        , Xuce        , Xuce        , Xuce        , Xuce        , Xuce        , Uue^Ii      , Rd          , Xuce        , Xuce        , Xuce        , Xuce        , Xuce        , Wot         , Wot         , Wot         , Xuce        , Wot         , Wot         , Wot         , Wot         , Wot         
Wot         , Wot         , Wot         , Wot         , Xuce        , Xuce        , Xuce        , Xuce        , Xuce        , Xuce        , Uue         , Xuce        , Xuce        , Xuce        , Xuce        , Uh          , Uue^Em      , Uue         , Xuce        , Xuce        , Xuce        , Xuce        , Xuce        , Xuce        , Xuce        , Xuce        , Xuce        , Xuce        , Xuce        , Wot         , Wot         , Wot         
Wot         , Wot         , Xuce        , Xuce        , Xuce        , Xuce        , Xuce        , Xuce        , Xuce        , Rd          , Xuce        , Uue^Uf      , Xuce        , Xuce        , Xuce        , Uue^Ufi     , Uh          , Xuce        , Uh          , Uue^Uf      , Uh          , Xuce        , Xuce        , Xuce        , Xuce        , Xuce        , Wwg         , Xuce        , Xuce        , Xuce        , Xuce        , Xuce        
Xuce        , Xuce        , Xuce        , Xuce        , Xuce        , Xuce        , Rd          , Uue         , Uue^Uf      , Uh          , Xuce        , Uue^Ii      , Xuce        , Xuce        , Xuce        , Uue^Em      , Uue^Es      , Xuce        , Uue         , Xuce        , Uue^Ii      , Xuce        , Qlf^Ii      , Xuce        , Qlf^Ii      , Wwg         , Dd^Em       , Wwg         , Wwg         , Xuce        , Xuce        , Xuce        
Xuce        , Xuce        , Xuce        , Xuce        , Xuce        , Xuce        , Rd          , Xuce        , Xuce        , Xuce        , Xuce        , Qlf^Ii      , Qlf^Ii      , Xuce        , Uue^Em      , Uue         , Uue         , Uue         , Xuce        , Xuce        , Xuce        , Qlf^Ii      , Xuce        , Qlf^Ii      , Xuce        , Wwg         , Wwg         , Dd^Es       , Wwg         , Qlf^Ii      , Xuce        , Xuce        
Xuce        , Xuce        , Xuce        , Xuce        , Uue^Uf      , Uue^Uf      , Uue         , Uue         , Rd          , Xuce        , Xuce        , Xuce        , Xuce        , Uue^Ufi     , Uue^Es      , Uue^Vud     , Xuce        , Rd          , Rd          , Xuce        , Xuce        , Xuce        , Xuce        , Xuce        , Xuce        , Wog         , Wwg         , Dd^Em       , Wwg         , Wwg         , Xuce        , Xuce        
Xuce        , Xuce        , Xuce        , Uue         , Uue         , Uue^Em      , Xuce        , Xuce        , Xuce        , Uh          , Xuce        , Xuce        , Uue^Es      , Rd          , Xuce        , Xuce        , Xuce        , Xuce        , Xuce        , Uue^Es      , Uue         , Xuce        , Uue^Ii      , Uue^Es      , Uh          , Xuce        , Xuce        , Xuce        , Xuce        , Uue^Uf      , Xuce        , Xuce        
Xuce        , Xuce        , Uue         , Rd          , Xuce        , Xuce        , Xuce        , Xuce        , Xuce        , Rd          , Uue         , Uue         , Uh          , Uue^Uf      , Xuce        , Xuce        , Xuce        , Xuce        , Xuce        , Uh^Em       , Uue^Es      , Uue         , Xuce        , Uue         , Uue         , Uue         , Xuce        , Xuce        , Xuce        , Uue^Es      , Xuce        , Xuce        
Xuce        , Xuce        , Uue^Em      , Uue         , Xuce        , Xuce        , Xuce        , Xuce        , Xuce        , Xuce        , Uue         , Uue^Es      , Xuce        , Xuce        , Xuce        , Xuce        , Xuce        , Xuce        , Xuce        , Xuce        , Uue         , Uh          , Xuce        , Xuce        , Uue         , Uue         , Rd          , Xuce        , Uue         , Rd          , Xuce        , Xuce        
Xuce        , Xuce        , Uue^Es      , Uh          , Xuce        , Xuce        , Xuce        , Xuce        , Uue         , Xuce        , Uue^Em      , Uue         , Uue^Uf      , Xuce        , Uue         , Uue         , Rd^Em       , Uue^Ufi     , Rd          , Uue         , Uue^Ii      , Xuce        , Xuce        , Xuce        , Rd          , Uue^Uf      , Xuce        , Uue^Es      , Uue^Ufi     , Xuce        , Xuce        , Xuce        
Uue^Uf      , Rd          , Xuce        , Xuce        , Xuce        , Xuce        , Uue         , Uue^Es      , Xuce        , Rd          , Rd^Es       , Rd          , Rd          , Rd^Em       , Xuce        , Xuce        , Xuce        , Uh^Em       , Xuce        , Uue         , Uue         , Xuce        , Xuce        , Xuce        , Uh          , Xuce        , Xuce        , Xuce        , Uue         , Xuce        , Xuce        , Xuce        
Uue^Es      , Uue         , Xuce        , Xuce        , Xuce        , Uh          , Uue^Ufi     , Xuce        , Xuce        , Xuce        , Xuce        , Uh          , Rd^Es       , Uue^Ufi     , Xuce        , Xuce        , Xuce        , Xuce        , Xuce        , Xuce        , Rd          , Xuce        , Xuce        , Xuce        , Rd          , Xuce        , Xuce        , Xuce        , Xuce        , Rd          , Xuce        , Xuce        
Uh          , Uue         , Xuce        , Xuce        , Xuce        , Uue^Ii      , Hd          , Xuce        , Xuce        , Xuce        , Xuce        , Xuce        , Xuce        , Xuce        , Xuce        , Xuce        , Uue         , Xuce        , Xuce        , Xuce        , Uue^Uf      , Uue^Uf      , Xuce        , Xuce        , Uue         , Uue         , Uue^Es      , Xuce        , Uue^Uf      , Uue^Es      , Xuce        , Xuce        
Uh          , Rd          , Xuce        , Xuce        , Xuce        , Ds          , Wwg         , Wwg         , Wwg         , Wwg         , Wwg         , Xuce        , Xuce        , Xuce        , Xuce        , Uue         , Uue^Ii      , Uue^Es      , Xuce        , Xuce        , Xuce        , Rd^Em       , Uue^Uf      , Uue^Uf      , Uue         , Uue         , Xuce        , Rd          , Uue         , Uue         , Xuce        , Xuce        
Uh          , Rd          , Xuce        , Xuce        , Wwg         , Wwg         , Ha          , Ha          , Ms^Xm       , Ms          , Ms^Xm       , Wwg         , Xuce        , Xuce        , Xuce        , Uue^Es      , Uue         , Uue         , Xuce        , Xuce        , Xuce        , Uue         , Uue         , Uue^Uf      , Xuce        , Xuce        , Xuce        , Xuce        , Uue         , Uue^Ii      , Xuce        , Xuce        
Uh          , Rd          , Xuce        , Xuce        , Wwg         , Ms          , Ms^Xm       , Ha          , Ms^Xm       , Ha          , Wwrg        , Wwg         , Wwg         , Xuce        , Xuce        , Xuce        , Rd          , Xuce        , Xuce        , Xuce        , Uue^Es      , Uue         , Uue^Es      , Uue         , Xuce        , Xuce        , Xuce        , Xuce        , Uh          , Uue         , Xuce        , Xuce        
Uue         , Uue         , Xuce        , Xuce        , Wwg         , Ms          , Ms^Xm       , Ms^Xm       , Ha          , Ms          , Wwg         , Wwg         , Wwg         , Xuce        , Xuce        , Xuce        , Uh          , Uue^Em      , Rd          , Xuce        , Uue         , Rd          , Rd          , Xuce        , Xuce        , Xuce        , Xuce        , Xuce        , Uh^Em       , Rd          , Xuce        , Xuce        
Uue^Em      , Uue         , Xuce        , Xuce        , Xuce        , Wwg         , Wwg         , Ha          , Wwrg        , Ms^Xm       , Wwg         , Wwg         , Xuce        , Xuce        , Xuce        , Rd          , Xuce        , Xuce        , Xuce        , Rd          , Rd^Es       , Uue         , Rd          , Uh          , Xuce        , Xuce        , Xuce        , Xuce        , Rd          , Rd          , Xuce        , Xuce        
Uh          , Uue^Es      , Rd          , Xuce        , Xuce        , Wwg         , Wwg         , Wwg         , Wwg         , Wwg         , Wwg         , Xuce        , Xuce        , Xuce        , Uh          , Uue^Uf      , Xuce        , Xuce        , Xuce        , Uh          , Uue^Ufi     , Uue^Em      , Uh^Em       , Rd          , Uue         , Xuce        , Uue         , Uue         , Uh          , Uh^Em       , Xuce        , Xuce        
Xuce        , Xuce        , Rd^Es       , Xuce        , Xuce        , Xuce        , Xuce        , Wwg         , Wwg         , Wwg         , Wwg         , Xuce        , Xuce        , Xuce        , Uue^Ii      , Uue^Em      , Xuce        , Xuce        , Xuce        , Xuce        , Xuce        , Uue^Uf      , Xuce        , Uue^Es      , Uue         , Rd          , Xuce        , Uue^Es      , Xuce        , Xuce        , Xuce        , Xuce        
Xuce        , Xuce        , Xuce        , Rd          , Uh          , Xuce        , Xuce        , Ds          , Wwg         , Wwg         , Wwg         , Ds          , Ds          , Xuce        , Ds          , Xuce        , Xuce        , Xuce        , Xuce        , Xuce        , Xuce        , Xuce        , Xuce        , Xuce        , Uue^Ii      , Xuce        , Xuce        , Xuce        , Xuce        , Xuce        , Xuce        , Xuce        
Xuce        , Xuce        , Xuce        , Xuce        , Uue^Ii      , Xuce        , Ds          , Ds          , Wog         , Wog         , Wog         , Wog         , Wog         , Ds          , Wwg^Bw|r    , Ds          , Ds          , Xuce        , Xuce        , Xuce        , Qxe         , Xuce        , Xuce        , Xuce        , Ds          , Xuce        , Ds          , Xuce        , Wog         , Xuce        , Xuce        , Xuce        
Xuce        , Xuce        , Wog         , Xuce        , Ds          , Ds          , Wog^Bw\r    , Wog         , Wog         , Wog         , Wog         , Wog         , Wog         , Wog         , Wog^Bw|r    , Wwg         , Wog         , Ds          , Ds          , Ds          , Ds          , Xuce        , Ds          , Ds          , Wog^Bw|r    , Ds          , Wog         , Wog         , Wog         , Wog         , Wog         , Wwrg        
Wog         , Wog         , Wog         , Wog         , Wog         , Wog         , Wog^Bw|r    , Wog         , Wog         , Wog         , Wog         , Wog         , Wog         , Wog         , Wog^Bw|r    , Wog         , Wog         , Wog         , Wog         , Wog         , Wog         , Wwrg        , Wog         , Wog         , Wog^Bw|r    , Wog         , Wog         , Wog         , Wog         , Wog         , Wog         , Wog         
Wog         , Wog         , Wog         , Wog         , Wog         , Wog         , Wog^Bw|r    , Wog         , Wog         , Wog         , Wog         , Wog         , Wog         , Wog         , Wog^Bw|r    , Wog         , Wog         , Wog         , Wog         , Wog         , Wog         , Wog         , Wog         , Wog         , Wog^Bw|r    , Wog         , Wog         , Wog         , Wog         , Wog         , Wog         , Wog         
Wog         , Wog         , Wog         , Wog         , Wog         , Wog         , Wog^Bw|r    , Wog         , Wog         , Wog         , Wog         , Wog         , Wog         , Wog         , Wog^Bw|r    , Wog         , Wog         , Wog         , Wog         , Wog         , Wog         , Wog         , Wog         , Wog         , Wog^Bw|r    , Wog         , Wog         , Wog         , Wog         , Wog         , Wog         , Wog         
Wwg         , Wwg         , Wwg         , Wwg         , Wwg         , Wwg         , Wwg^Bw|r    , Wwg         , Wwg         , Wwg         , Wwg         , Wwg         , Wwg         , Wwg         , Wwg^Bw|r    , Wwg         , Wwg         , Wwg         , Wwg         , Wwg         , Wwg         , Wwg         , Wwg         , Wwg         , Wwg^Bw|r    , Wwg         , Wwg         , Wwg         , Wwg         , Wwg         , Wwg         , Wwg         
Wwg         , Gs          , Gs          , Gs          , Gs          , Gs          , Gs          , Gs          , Gs          , Gs          , Gs          , Gs          , Gs          , Gs          , Gs          , Gs          , Gs          , Gs          , Gs          , Gs          , Gs          , Gs          , Gs          , Gs          , Gs          , Gs          , Gs          , Gs          , Gs          , Gs          , Gs          , Wwg         
Gs          , Gs          , Gs          , Gs          , Gs          , Gs          , Gs          , Gs          , Gs          , Gs          , Gs          , Gs          , Gs          , Gs          , Gs          , Gs          , Gs          , Gs          , Gs          , Gs          , Gs          , Gs          , Gs          , Gs          , Gs          , Gs          , Gs          , Gs          , Gs          , Gs          , Gs          , Gs          
Gs          , Gs          , Gs          , Gs          , Gs          , Gs          , Gs          , Gs          , Gs          , Gs          , Gs          , Gs          , Gs          , Gs          , Gs          , Gs          , Gs          , Gs          , Gs          , Gs          , Gs          , Gs          , Gs          , Gs          , Gs          , Gs          , Gs          , Gs          , Gs          , Gs          , Gs          , Gs          
