border_size=1
usage=map

Xue         , Xue         , Xue         , Xue         , Xue         , Xue         , Xue         , Xue         , Xue         , Xue         , Xue         , Xue         , Xue         , Xue         , Xue         , Xue         , Xue         , Xue         , Xue         , Wog         , Wog         , Wog         
Xue         , Xue         , Xue         , Xue         , Xue         , Xue         , Xue         , Xue         , Xue         , Xue         , Xue         , Xue         , Xue         , Xue         , Xue         , Xue         , Xue         , Xue         , Xue         , Wog         , Wog         , Wog         
Xue         , Xue         , Xue         , Xue         , Xue         , Xue         , Uue         , Uu^Vud      , Uue         , Xue         , Re          , Xue         , Xue         , Xue         , Xue         , Xue         , Xue         , Xue         , Wog         , Wog         , Wog         , Wog         
Xue         , Xue         , Xue         , Xue         , Xue         , Xue         , Uue         , Uue         , Wwg         , Uue         , Wwg         , Uue         , Uue         , Xue         , Xue         , Xue         , Xue         , Wog         , Wog         , Wog         , Xue         , Xue         
Xue         , Xue         , Xue         , Xue         , Uue         , Uue         , Wwg         , Wwg         , Wog         , Wog         , Wog         , Wwg         , Uh          , Uue         , Xue         , Xue         , Xue         , Wog         , Wog         , Xue         , Xue         , Xue         
Xue         , Xue         , Xue         , Re          , Uue         , Wog         , Wog         , Wog         , Wog         , Wog         , Wog         , Wog         , Wwg         , Re          , Xue         , Xue         , Wog         , Wog         , Wog         , Xue         , Xue         , Xue         
Xue         , Xue         , Xue         , Uue         , Uue         , Wog         , Wog         , Wog         , Wog         , Wog         , Xue         , Wwg         , Wwg         , Uue         , Xue         , Xue         , Wog         , Wog         , Wog         , Xue         , Xue         , Xue         
Xue         , Xue         , Uh          , Uh          , Xue         , Wog         , Wog         , Wog         , Xue         , Xue         , Xue         , Xue         , Uue         , Uue         , Xue         , Xue         , Wog         , Wog         , Wog         , Wog         , Xue         , Xue         
Xue         , Xue         , Uh          , Xue         , Xue         , Wog         , Wog         , Wog         , Xue         , Xue         , Xue         , Uu^Ii       , Xue         , Xue         , Xue         , Xue         , Wog         , Wog         , Wog         , Wog         , Xue         , Xue         
Xue         , Xue         , Uue         , Xue         , Xue         , Wog         , Wog         , Wog         , Wog         , Xue         , Xue         , Xue         , Xue         , Xue         , Wog         , Wog         , Wog         , Wog         , Xue         , Xue         , Xue         , Xue         
Xue         , Xue         , Uue         , Xue         , Xue         , Xue         , Xue         , Wog         , Wog         , Wog         , Wog         , Xue         , Wog         , Wog         , Wog         , Wog         , Wog         , Xue         , Xue         , Xue         , Xue         , Xue         
Xue         , Xue         , Re          , Xue         , Wog         , Xue         , Wog         , Wog         , Wog         , Wog         , Wog         , Wog         , Wog         , Wog         , Wog         , Wog         , Wog         , Wog         , Xue         , Xue         , Xue         , Xue         
Xue         , Xue         , Xue         , Uue         , Wwg         , Wog         , Wog         , Wog         , Xue         , Xue         , Xue         , Wog         , Wog         , Wog         , Wog         , Wog         , Wog         , Wog         , Xue         , Xue         , Xue         , Xue         
Xue         , Xue         , Xue         , Uue         , Wwg         , Wwg         , Wog         , Xue         , Xue         , Xue         , Xue         , Wog         , Xue         , Xue         , Xue         , Wog         , Wog         , Xue         , Xue         , Xue         , Xue         , Xue         
Xue         , Xue         , Xue         , Uue         , Uue         , Wwg         , Wwg         , Xue         , Wog         , Xue         , Xue         , Xue         , Xue         , Xue         , Xue         , Wog         , Xue         , Xue         , Xue         , Xue         , Xue         , Xue         
Xue         , Xue         , Xue         , Xue         , Uue         , Wwg         , Wwg         , Wwg         , Wog         , Wog         , Wog         , Xue         , Xue         , Xue         , Xue         , Xue         , Xue         , Xue         , Xue         , Xue         , Xue         , Xue         
Xue         , Xue         , Xue         , Xue         , Re          , Wwg         , Wwg         , Wwg         , Wwg         , Wwg         , Xue         , Xue         , Xue         , Xue         , Xue         , Xue         , Xue         , Xue         , Xue         , Xue         , Xue         , Xue         
Xue         , Xue         , Xue         , Xue         , Uue         , Xue         , Xue         , Wwg         , Xue         , Xue         , Xue         , Xue         , Xue         , Xue         , Xue         , Xue         , Xue         , Xue         , Xue         , Xue         , Xue         , Xue         
Xue         , Xue         , Xue         , Xue         , Uue         , Xue         , Xue         , Xue         , Xue         , Xue         , Xue         , Xue         , Xue         , Xue         , Xue         , Xue         , Xue         , Xue         , Xue         , Xue         , Xue         , Xue         
Xue         , Xue         , Uue         , Uue         , Uue         , Xue         , Xue         , Xue         , Xue         , Xue         , Xue         , Xue         , Xue         , Xue         , Xue         , Xue         , Xue         , Xue         , Xue         , Xue         , Xue         , Xue         
Uh          , Uue         , Re          , Re          , Uue         , Xue         , Xue         , Xue         , Xue         , Xue         , Xue         , Xue         , Xue         , Xue         , Xue         , Xue         , Xue         , Xue         , Xue         , Xue         , Xue         , Xue         
Uue         , Uue         , Uue         , Uue         , Uue         , Xue         , Xue         , Xue         , Xue         , Xue         , Xue         , Xue         , Xue         , Xue         , Xue         , Xue         , Xue         , Xue         , Xue         , Xue         , Xue         , Xue         
