border_size=1
usage=map

Wwrt        , Wwrt        , Dd          , Dd          , Ds^Vda      , Dd          , Dd          , Gd          , Gd^Fms      , Gs          , Gd^Fms      , Gd^Fms      , Gs^Fms      , Gs^Fms      , Gs^Efm      , Gs^Efm      , Gs^Efm      , Gs          , Gs          , Rd          , Gs          , Gs          
Wot         , Wot         , Dd          , Dd          , Dd          , Dd          , Dd          , Gd          , Gd^Fms      , Gs          , Gs^Fms      , Gs^Fms      , Gs^Fms      , Gs^Fms      , Gs          , Gs          , Gs          , Gs          , Gd^Vwm      , Rd          , Gs          , Gs          
Wot         , Wot         , Dd          , Dd          , Dd          , Dd          , Dd          , Gd          , Gs^Fms      , Gs^Efm      , Gs^Fms      , Gs^Fms      , Gd^Fms      , Gd^Fms      , Gs          , Gs          , Gs          , Gs          , Rd          , Rd          , Gs          , Gs          
Wot         , Wot         , Dd          , Dd          , Dd          , Ds^Vda      , Dd          , Gd          , Gd          , Gd^Fms      , Gd^Efm      , Gs^Fms      , Gd^Fms      , Gs^Efm      , Gs          , Gs          , Rd          , Rd          , Gs          , Gs          , Gs          , Gs          
Wot         , Wot         , Wwt^Bw/     , Dd          , Dd          , Dd          , Dd          , Dd          , Dd          , Gs          , Gd          , Gs          , Gd          , Gs          , Rd          , Rd          , Gs          , Gs          , Gs          , Gs          , Gs          , Gs          
Wot         , Wot         , Wot         , Dd          , Wwrt        , Dd          , Dd          , Dd          , Rd^Vda      , Dd          , Dd          , Gd          , Rd          , Rd          , Gs          , Gs          , Gs          , Gs          , Gs          , Gs          , Gs          , Gs          
Wot         , Wot         , Wot         , Wot         , Dd          , Dd          , Dd          , Rd          , Dd          , Rd          , Rd          , Rd          , Gd          , Gs          , Gs          , Gs^Efm      , Gs          , Gs^Efm      , Gs^Efm      , Gs          , Gs          , Gs          
Wot         , Wot         , Wot         , Wwt^Bw/     , Dd          , Dd          , Rd          , Rd          , Dd          , Dd          , Rd          , Dd          , Dd          , Gd          , Gd          , Gs          , Gs          , Gs^Efm      , Gs          , Gs          , Gs^Fms      , Gd^Fms      
Wot         , Wot         , Wot         , Wot         , Wwt         , Rd          , Dd          , Dd          , Dd          , Dd          , Dd          , Rd^Vda      , Dd          , Dd          , Gd          , Gs          , Gs^Fms      , Gs          , Gs^Fms      , Gs          , Gs^Fms      , Gs^Fms      
Wot         , Wot         , Wot         , Wot         , Wwt^Bw/     , Rd          , Dd          , Dd          , Dd          , Dd          , Dd          , Rd          , Dd          , Dd          , Dd          , Gs          , Gs          , Gd^Fms      , Gs^Fms      , Gs          , Gs          , Gs          
Wot         , Wot         , Wot         , Wot         , Wot         , Dd          , Wwrt        , Dd          , Dd          , Dd          , Dd          , Rd          , Rd          , Dd          , Dd          , Gd          , Gd          , Gd^Efm      , Gd^Fms      , Gs^Fms      , Gd^Fms      , Gs^Fms      
Wot         , Wot         , Wot         , Wot         , Wot         , Wot         , Wot         , Wwt         , Dd          , Dd          , Dd          , Dd          , Dd          , Ds^Vda      , Dd          , Dd          , Gd          , Gs          , Gd^Fms      , Gs^Fms      , Gd          , Gd          
Wot         , Wot         , Wot         , Wot         , Wot         , Wot         , Wot         , Wwt^Bw/     , Dd          , Dd          , Dd          , Dd          , Dd          , Dd          , Dd          , Dd          , Dd          , Gd          , Gd          , Gs^Fms      , Gd^Efm      , Gd          
Wot         , Wot         , Wot         , Wot         , Wot         , Wot         , Wot         , Wot         , Dd          , Dd          , Dd          , Dd          , Dd          , Dd          , Dd          , Dd          , Ds^Vda      , Dd          , Gd          , Gd^Fms      , Gd^Fms      , Gd^Fms      
Wot         , Wot         , Wot         , Wot         , Wot         , Wot         , Wot         , Wwt^Bw/     , Dd          , Dd          , Dd          , Dd          , Dd          , Dd          , Dd          , Dd          , Dd          , Dd          , Dd          , Gd          , Gd          , Gd          
Wot         , Wot         , Wot         , Wot         , Wot         , Wot         , Wot         , Wwt         , Dd          , Dd          , Dd          , Dd          , Dd          , Dd          , Dd          , Dd          , Dd          , Dd          , Rd          , Dd          , Dd          , Dd          
Wot         , Wot         , Wot         , Wot         , Wot         , Wot         , Wot         , Wwt^Bw/     , Dd          , Dd          , Dd          , Dd          , Dd          , Dd          , Dd          , Dd          , Rd          , Rd          , Dd          , Rd^Vda      , Rd          , Dd          
Wot         , Wot         , Wot         , Wot         , Wot         , Wot         , Wot         , Wwt         , Wot         , Dd          , Wwt         , Dd          , Dd          , Dd          , Dd          , Dd          , Rd          , Dd          , Dd          , Dd          , Dd          , Rd          
Wot         , Wot         , Wot         , Wot         , Wot         , Wot         , Wot         , Wot         , Wot         , Wot         , Dd          , Wwrt        , Ds^Vda      , Dd          , Dd          , Dd          , Rd          , Dd          , Dd          , Dd          , Dd          , Dd          
Wot         , Wot         , Wot         , Wot         , Wot         , Wot         , Wot         , Wot         , Wwrt        , Dd          , Dd          , Dd          , Dd          , Rd          , Rd          , Rd          , Dd          , Dd          , Dd          , Dd          , Dd          , Dd          
Wot         , Wot         , Wot         , Wot         , Wot         , Wot         , Wot         , Wot         , Wot         , Wwt         , Dd          , Dd          , Dd          , Dd          , Dd          , Dd          , Dd          , Dd          , Dd          , Dd          , Dd          , Dd          
Wot         , Wot         , Wot         , Wot         , Wot         , Wot         , Wot         , Wot         , Wot         , Wwrt        , Dd          , Dd          , Dd          , Dd          , Dd          , Dd          , Dd          , Dd          , Dd          , Dd          , Dd          , Dd          
