border_size=1
usage=map

Gs          , Gs          , Gs          , Gs          , Gs          , Gs          , Gs          , Gs          , Gs          , Gs          , Gs          , Gs          , Gs          , Gs          , Gs          , Gs          , Gs^Fms      , Gs^Fms      , Gs^Fms      , Gs          , Gs          , Gs          , Gs          , Gs          , Gs^Fms      , Gs^Efm      , Gs          , Gs          , Gs          , Gs          , Gs          , Gs^Fms      , Ds          , Ds          , Wwt         , Wwt         , Wot         , Wot         , Wot         , Wot         , Wot         
Gs          , Gs          , Gs          , Gs          , Gs          , Gs          , Gs          , Gs          , Gs          , Gs          , Gs          , Gs          , Gs          , Gs          , Gs          , Gs          , Gs^Fms      , Gs^Fms      , Gs^Fms      , Gs          , Gs          , Gs          , Gs          , Gs^Efm      , Gs^Fms      , Gs^Efm      , Gs          , Gs          , Gs          , Gs          , Gs          , Gs^Fms      , Ds          , Ds          , Wwt         , Wwt         , Wot         , Wot         , Wot         , Wot         , Wot         
Gs          , Gs          , Gs          , Gs          , Gs          , Gs          , Gs          , Gs          , Gs          , Gs^Efm      , Gs          , Gs          , Gs          , Gs          , Gs          , Gs          , Gs^Fms      , Gs^Fms      , Gs^Fms      , Gs          , Gs          , Gs          , Gs          , Gs          , Gs^Fms      , Gs^Efm      , Gs          , Gs          , Gs          , Gs          , Gs          , Gs^Fms      , Ds          , Ds          , Wwt         , Wwt         , Wot         , Wot         , Wot         , Wot         , Wot         
Gs          , Gs          , Gs          , Gs          , Gs          , Gs          , Gs          , Gs          , Gs          , Gs          , Gs          , Gs          , Gs          , Gs          , Gs          , Gs          , Gs          , Gs^Fms      , Gs^Fms      , Gs          , Gs          , Gs          , Gs          , Gs          , Gs          , Gs          , Gs          , Gs          , Gs          , Gs          , Gs^Fms      , Gs^Fms      , Ds          , Ds          , Wwt         , Wot         , Wot         , Wot         , Wot         , Wot         , Wot         
Gs          , Gs          , Gs          , Gs          , Gs          , Gs          , Gs^Efm      , Gs          , Gs          , Gs          , Gs          , Gs          , Gs^Fms      , Gs          , Gs          , Gs          , Gs          , Gs^Fms      , Gs^Fms      , Gs^Fms      , Gs^Fms      , Gs^Fms      , Gs          , Gs          , Gs          , Gs          , Gs          , Gs          , Gs          , Gs^Fms      , Ds          , Ds          , Ds          , Wwt         , Wot         , Wot         , Wot         , Wot         , Wot         , Wot         , Wot         
Gs          , Gs^Efm      , Gs          , Gs          , Gs          , Gs          , Gs          , Gs          , Gs          , Gs          , Gs          , Gs^Fms      , Gs^Fms      , Gs^Fms      , Ds          , Ds          , Gs          , Gs          , Gs          , Gs^Fms      , Gs          , Gs          , Gs          , Gs          , Gs          , Gs          , Gs          , Gs          , Gs          , Gs^Fms      , Ds          , Wwt         , Wwt         , Wwt         , Wot         , Wot         , Wot         , Wot         , Wot         , Wot         , Wot         
Gs          , Gs          , Gs          , Gs          , Gs          , Gs          , Gs          , Gs          , Gs          , Gs^Fms      , Gs^Fms      , Gs^Fms      , Gs^Fms      , Ds          , Ds          , Ds          , Gs          , Gs          , Gs          , Gs          , Gs^Fms      , Gs          , Gs^Fms      , Gs^Fms      , Gs          , Gs          , Gs          , Gs          , Gs          , Gs^Fms      , Gs^Fms      , Ds          , Wwt         , Wot         , Wot         , Wot         , Wot         , Wot         , Wot         , Wot         , Wot         
Gs          , Gs          , Gs          , Gs          , Gs          , Gs          , Gs          , Gs          , Gs^Fms      , Gs^Fms      , Gs^Fms      , Ss          , Ds          , Ds          , Ds          , Ds          , Gs^Fms      , Gs          , Gs          , Gs^Fms      , Gs^Fms      , Gs^Fms      , Gs^Fms      , Gs^Fms      , Gs          , Gs          , Gs          , Gs          , Gs^Efm      , Gs^Fms      , Ds          , Ds          , Wwt         , Wot         , Wot         , Wot         , Wot         , Wot         , Wot         , Wot         , Wot         
Gs          , Gs          , Gs          , Gs          , Gs          , Gs          , Gs          , Gs^Fms      , Gs^Fms      , Gs^Efm      , Gs^Fms      , Ss          , Ss          , Ds          , Ds          , Ds          , Gs^Efm      , Gs          , Gs          , Gs^Fms      , Gs^Fms      , Gs^Fms      , Gs^Efm      , Gs^Fms      , Gs          , Gs          , Gs          , Gs          , Gs^Fms      , Gs^Fms      , Ds          , Ds          , Wwt         , Wot         , Wot         , Wot         , Wot         , Wot         , Wot         , Wot         , Wot         
Gs          , Gs          , Gs          , Gs          , Gs          , Gs          , Gs          , Gs^Fms      , Gs          , Gs          , Gs          , Ss          , Ss          , Gs^Fms      , Gs^Fms      , Ds          , Ds          , Gs^Fms      , Gs          , Gs^Fms      , Gs^Fms      , Gs^Efm      , Gs^Efm      , Gs^Fms      , Gs          , Gs          , Gs          , Gs          , Gs^Fms      , Ds          , Ds          , Wwt         , Wwt         , Wot         , Wot         , Wot         , Wot         , Wot         , Wot         , Wot         , Wot         
Gs          , Gs          , Gs          , Gs          , Gs          , Gs          , Gs          , Gs          , Gs          , Gs          , Gs          , Gs          , Gs          , Gs^Fms      , Gs          , Gs^Efm      , Ds          , Ds          , Gs          , Gs^Fms      , Gs^Fms      , Gs^Fms      , Gs^Fms      , Gs^Fms      , Gs          , Gs          , Gs          , Gs^Fms      , Gs^Fms      , Gs^Fms      , Ds          , Ds          , Wwt         , Wot         , Wot         , Wot         , Wot         , Wot         , Wot         , Wot         , Wot         
Gs          , Gs          , Gs          , Gs          , Gs          , Gs          , Gs          , Gs^Fms      , Gs^Fms      , Gs          , Gs          , Gs          , Gs          , Gs          , Gs          , Ds          , Ds          , Ww          , Ds          , Gs          , Gs^Fms      , Gs^Fms      , Gs^Fms      , Gs          , Gs          , Gs          , Gs          , Gs^Fms      , Gs^Fms      , Ds          , Ds          , Ds          , Wwt         , Wot         , Wot         , Wot         , Wot         , Wot         , Wot         , Wot         , Wot         
Gs          , Gs          , Gs          , Gs          , Gs          , Gs          , Gs^Fms      , Gs^Fms      , Gs^Fms      , Gs          , Gs          , Gs          , Gs          , Gs          , Gs          , Ds          , Ds          , Ww          , Ds          , Ds          , Gs^Fms      , Gs^Fms      , Gs          , Gs          , Gs          , Gs          , Gs          , Gs^Fms      , Gs^Fms      , Gs^Fms      , Gs^Fms      , Ds          , Wwt         , Wot         , Wot         , Wot         , Wot         , Wot         , Wot         , Wot         , Wot         
Gs          , Gs          , Gs          , Gs          , Gs          , Gs^Fms      , Gs^Efm      , Gs^Fms      , Gs          , Gs          , Gs          , Gs          , Gs          , Ds          , Ds          , Ds          , Ww          , Ds          , Ds          , Ds          , Gs^Fms      , Gs^Efm      , Gs          , Gs          , Gs          , Gs          , Gs          , Gs^Efm      , Hh^Fp       , Hh          , Hh          , Ds          , Wwt         , Wot         , Wot         , Wot         , Wot         , Wot         , Wot         , Wot         , Wot         
Gs          , Gs          , Gs          , Gs          , Gs^Fms      , Gs^Fms      , Gs          , Gs          , Gs          , Gs          , Gs          , Gs          , Gs          , Ds          , Ds          , Ds          , Ds          , Ds          , Ds          , Gs^Fms      , Gs^Fms      , Gs          , Gs          , Gs          , Gs          , Gs          , Hh          , Hh          , Mm          , Mm          , Mm          , Ds          , Wwt         , Wot         , Wot         , Wot         , Wot         , Wot         , Wot         , Wot         , Wot         
Gs          , Gs          , Gs          , Gs          , Gs          , Gs          , Gs          , Gs          , Gs          , Gs^Fms      , Gs^Fms      , Gs          , Gs^Efm      , Gs^Fms      , Gs^Fms      , Gs^Fms      , Ss          , Ds          , Ss          , Gs^Fms      , Gs^Fms      , Gs^Fms      , Gs^Efm      , Gs          , Gs          , Gs^Fms      , Hh^Fp       , Mm          , Mm          , Mm^Vhh      , Mm          , Ds          , Wwt         , Wot         , Wot         , Wot         , Wot         , Wot         , Wot         , Wot         , Wot         
Gs          , Gs          , Gs          , Hh          , Hh          , Hh          , Hh^Fms      , Gs^Fms      , Gs^Fms      , Gs^Fms      , Gs^Fms      , Gs^Fms      , Gs          , Gs          , Gs          , Gs^Fms      , Ss          , Ss          , Ss          , Gs^Fms      , Gs^Fms      , Gs^Fms      , Gs^Fms      , Gs^Fms      , Gs          , Gs^Fms      , Mm          , Mm          , Mm          , Mm          , Ds          , Ds          , Wwt         , Wot         , Wot         , Wot         , Wot         , Wot         , Wot         , Wot         , Wot         
Gs          , Gs          , Gs          , Hh^Fms      , Hh^Fms      , Hh          , Hh          , Gs^Fms      , Gs^Fms      , Gs^Fms      , Gs^Fms      , Gs^Fms      , Gs          , Gs          , Gs          , Gs          , Gs^Fms      , Gs^Fms      , Gs^Fms      , Gs^Fms      , Gs          , Gs          , Gs          , Gs          , Gs          , Hh          , Mm          , Mm          , Mm          , Mm          , Ds          , Wwt         , Wot         , Wot         , Wot         , Wot         , Wot         , Wot         , Wot         , Wot         , Wot         
Gs          , Gs          , Gs          , Gs^Fms      , Hh          , Hh          , Gs^Fms      , Gs^Fms      , Gs^Fms      , Gs^Fms      , Gs^Fms      , Gs^Fms      , Gs^Fms      , Gs          , Gs          , Gs          , Gs          , Gs          , Gs          , Gs          , Gs          , Gs          , Gs^Efm      , Gs          , Gs          , Hh          , Mm          , Mm          , Mm          , Mm          , Ds          , Wot         , Wot         , Wot         , Wot         , Wot         , Wot         , Wot         , Wot         , Wot         , Wot         
Gs          , Gs          , Gs^Fms      , Gs          , Hh          , Hh^Fms      , Gs          , Gs^Fms      , Gs^Fms      , Gs^Fms      , Gs^Fms      , Gs          , Gs          , Gs^Fms      , Gs^Fms      , Gs          , Gs          , Gs          , Gs          , Gs          , Gs          , Gs          , Gs          , Gs          , Gs          , Hh          , Mm          , Mm          , Mm          , Mm          , Ds          , Wot         , Wot         , Wot         , Wot         , Wot         , Wot         , Wot         , Wot         , Wot         , Wot         
Gs          , Gs          , Gs^Fms      , Gs^Efm      , Gs          , Gs^Fms      , Gs          , Gs          , Gs^Fms      , Gs^Fms      , Gs^Fms      , Gs          , Gs          , Gs          , Gs          , Gs          , Gs          , Gs          , Gs          , Gs          , Gs          , Gs          , Gs          , Gs          , Gs          , Gs          , Gs          , Mm          , Ds          , Ds          , Wot         , Wot         , Wot         , Wot         , Wot         , Wot         , Wot         , Wot         , Wot         , Wot         , Wot         
Gs^Fms      , Gs^Fms      , Gs^Fms      , Gs^Fms      , Gs          , Gs          , Gs          , Gs          , Gs          , Gs          , Gs          , Gs          , Gs          , Gs          , Gs          , Gs          , Gs          , Gs^Efm      , Gs          , Gs          , Gs          , Gs          , Gs          , Gs          , Gs          , Gs          , Gs          , Gs^Fms      , Ds          , Wwt         , Wwt         , Wot         , Wot         , Wot         , Wot         , Wot         , Wot         , Wot         , Wot         , Wot         , Wot         
Gs^Fms      , Gs^Fms      , Gs^Fms      , Gs          , Gs          , Gs          , Gs          , Gs          , Gs          , Gs          , Gs^Fms      , Gs^Fms      , Gs^Fms      , Gs          , Gs          , Gs          , Gs          , Gs          , Gs          , Gs          , Gs          , Gs          , Gs          , Gs^Efm      , Gs          , Gs          , Gs^Fms      , Gs^Fms      , Gs^Fms      , Ds          , Wwt         , Wot         , Wot         , Wot         , Wot         , Wot         , Wot         , Wot         , Wot         , Wot         , Wot         
Gs^Fms      , Gs^Fms      , Gs          , Gs          , Gs          , Gs          , Gs          , Gs          , Gs^Fms      , Gs^Fms      , Gs^Fms      , Gs^Fms      , Gs^Fms      , Gs^Fms      , Gs          , Gs          , Gs          , Gs          , Hh^Fms      , Gs          , Gs^Fms      , Gs          , Gs          , Gs          , Gs          , Gs          , Gs^Fms      , Gs^Fms      , Ds          , Ds          , Wwt         , Wot         , Wot         , Wot         , Wot         , Wot         , Wot         , Wot         , Wot         , Wot         , Wot         
Gs^Fms      , Gs^Fms      , Gs          , Gs          , Gs          , Gs          , Gs          , Gs          , Gs          , Gs^Fms      , Ss          , Ss          , Gs^Fms      , Gs^Fms      , Gs          , Gs          , Hh          , Hh          , Hh^Fms      , Gs^Fms      , Gs^Fms      , Gs          , Gs          , Gs          , Gs          , Gs          , Gs^Fms      , Ds          , Wwt         , Wwt         , Wot         , Wot         , Wot         , Wot         , Wot         , Wot         , Wot         , Wot         , Wot         , Wot         , Wot         
Gs^Fms      , Gs^Fms      , Gs^Efm      , Gs          , Hh          , Hh          , Gs          , Gs          , Gs          , Gs          , Ss          , Ss          , Gs^Fms      , Gs^Fms      , Gs          , Gs          , Hh          , Hh          , Hh          , Hh^Fms      , Gs^Fms      , Gs^Efm      , Gs^Fms      , Gs          , Gs^Fms      , Gs^Fms      , Ds          , Ds          , Wwt         , Wot         , Wot         , Wot         , Wot         , Wot         , Wot         , Wot         , Wot         , Wot         , Wot         , Wot         , Wot         
Hh^Fms      , Hh          , Hh          , Mm          , Mm          , Mm          , Hh          , Gs          , Gs          , Gs          , Gs          , Ss          , Gs^Fms      , Gs          , Gs          , Gs          , Hh          , Hh          , Hh^Fms      , Gs^Fms      , Gs^Fms      , Gs^Fms      , Gs          , Gs          , Gs^Fms      , Ds          , Wwt         , Wwt         , Wot         , Wot         , Wot         , Wot         , Wot         , Wot         , Wot         , Wot         , Wot         , Wot         , Wot         , Wot         , Wot         
Mm          , Mm          , Mm          , Mm          , Mm          , Mm          , Hh          , Hh^Fms      , Gs^Fms      , Gs^Fms      , Gs^Fms      , Gs^Fms      , Gs^Fms      , Gs          , Gs          , Gs          , Hh          , Hh          , Hh          , Gs          , Gs^Fms      , Gs^Efm      , Gs          , Gs^Fms      , Ds          , Ds          , Wwt         , Wot         , Wot         , Wot         , Wot         , Wot         , Wot         , Wot         , Wot         , Wot         , Wot         , Wot         , Wot         , Wot         , Wot         
Mm          , Mm          , Mm          , Mm          , Mm          , Mm          , Mm          , Hh^Fms      , Gs          , Gs          , Gs^Fms      , Gs^Fms      , Gs          , Gs          , Gs          , Hh^Fms      , Gs^Fms      , Hh^Fms      , Hh          , Gs          , Gs          , Gs          , Gs          , Gs^Fms      , Ds          , Wwt         , Wot         , Wot         , Wot         , Wot         , Wot         , Wot         , Wot         , Wot         , Wot         , Wot         , Wot         , Wot         , Wot         , Wot         , Wot         
Mm          , Mm          , Mm          , Mm          , Mm          , Mm          , Mm          , Gs          , Gs          , Gs          , Gs          , Ds          , Gs          , Gs          , Gs          , Gs^Fms      , Gs^Fms      , Gs^Efm      , Gs          , Gs          , Gs          , Gs          , Gs^Fms      , Ds          , Wwt         , Wwt         , Wot         , Wot         , Wot         , Wot         , Wot         , Wot         , Wot         , Wot         , Wot         , Wot         , Wot         , Wot         , Wot         , Wot         , Wot         
Mm          , Mm          , Mm          , Mm          , Mm          , Mm          , Gs          , Gs          , Gs          , Gs          , Ds          , Ds          , Gs          , Gs          , Gs          , Gs^Efm      , Gs^Fms      , Gs          , Gs          , Gs          , Gs^Fms      , Gs^Efm      , Gs^Fms      , Ds          , Wwt         , Wot         , Wot         , Wot         , Wot         , Wot         , Wot         , Wot         , Wot         , Wot         , Wot         , Wot         , Wot         , Wot         , Wot         , Wot         , Wot         
Mm          , Mm          , Mm          , Mm          , Mm          , Hh          , Gs          , Gs          , Gs          , Gs          , Ds          , Ds          , Gs          , Gs          , Gs          , Gs          , Gs^Fms      , Gs          , Gs          , Gs^Fms      , Gs^Fms      , Gs^Fms      , Ds          , Ds          , Wwt         , Wot         , Wot         , Wot         , Wot         , Wot         , Wot         , Wot         , Wot         , Wot         , Wot         , Wot         , Wot         , Wot         , Wot         , Wot         , Wot         
Hh^Fms      , Hh^Fms      , Hh          , Hh          , Hh          , Gs          , Gs          , Gs          , Gs          , Gs          , Ds          , Ds          , Gs^Fms      , Gs^Fms      , Gs          , Gs          , Gs          , Gs          , Gs^Fms      , Gs^Fms      , Gs^Fms      , Gs^Fms      , Ds          , Wwt         , Wot         , Wot         , Wot         , Wot         , Wot         , Wot         , Wot         , Wot         , Wot         , Wot         , Wot         , Wot         , Wot         , Wot         , Wot         , Wot         , Wot         
Hh          , Hh          , Hh          , Gs          , Gs          , Gs          , Gs          , Gs          , Gs          , Gs          , Ds          , Ds          , Gs          , Gs          , Gs          , Gs          , Gs          , Gs^Fms      , Gs^Fms      , Gs^Fms      , Gs^Fms      , Gs^Fms      , Ds          , Wwt         , Wot         , Wot         , Wot         , Wot         , Wot         , Wot         , Wot         , Wot         , Wot         , Wot         , Wot         , Wot         , Wot         , Wot         , Wot         , Wot         , Wot         
Gs          , Gs          , Gs          , Gs          , Gs          , Gs          , Gs          , Gs          , Gs          , Gs          , Gs          , Ds          , Gs          , Gs          , Gs          , Gs          , Gs          , Gs          , Gs^Fms      , Gs^Fms      , Gs^Fms      , Gs^Fms      , Ds          , Wwt         , Wot         , Wot         , Wot         , Wot         , Wot         , Wot         , Wot         , Wot         , Wot         , Wot         , Ds          , Ds          , Ds          , Ds          , Ds          , Ds          , Ds          
Gs          , Gs          , Gs          , Gs          , Gs          , Gs          , Gs          , Gs          , Gs          , Gs          , Gs          , Gs          , Gs^Fms      , Gs          , Gs          , Gs          , Gs          , Gs          , Gs^Fms      , Gs^Fms      , Ds          , Ds          , Wwt         , Wwt         , Wot         , Wot         , Wot         , Wot         , Wot         , Wot         , Wot         , Wot         , Ds          , Ds          , Gs^Fms      , Gs^Fms      , Gs^Fms      , Gs^Fms      , Gs^Fms      , Gs^Fms      , Gs^Fms      
Gs          , Gs          , Gs          , Gs          , Gs          , Gs          , Gs          , Gs          , Ds          , Gs          , Ds          , Gs^Fms      , Ds          , Gs^Fms      , Ds          , Gs          , Ds          , Gs          , Ds          , Ds          , Wwt         , Wwt         , Wot         , Wot         , Wot         , Wot         , Wot         , Wot         , Wot         , Wot         , Wot         , Ds          , Gs^Fms      , Gs^Fms      , Gs^Fms      , Gs^Fms      , Gs^Fms      , Gs^Fms      , Gs^Fms      , Gs^Fms      , Gs^Fms      
Gs          , Gs          , Ds          , Ds          , Ds          , Ds          , Ds          , Ds          , Wwt         , Ds          , Wwt         , Ds          , Wwt         , Ds          , Wwt         , Ds          , Wwt         , Ds          , Wwt         , Wwt         , Wot         , Wot         , Wot         , Wot         , Wot         , Wot         , Wot         , Wot         , Wot         , Wot         , Ds          , Ds          , Gs^Fms      , Gs^Fms      , Gs^Fms      , Gs^Fms      , Gs^Fms      , Gs^Fms      , Gs^Fms      , Gs^Fms      , Gs^Fms      
Ds          , Ds          , Wwt         , Wwt         , Wwt         , Wwt         , Wwt         , Wwt         , Wot         , Wwt         , Wot         , Wwt         , Wot         , Wwt         , Wot         , Wwt         , Wot         , Wwt         , Wot         , Wot         , Wot         , Wot         , Wot         , Wot         , Wot         , Wot         , Wot         , Wot         , Wot         , Wot         , Ds          , Gs^Fms      , Gs^Fms      , Gs^Fms      , Gs^Fms      , Gs^Fms      , Hh^Fms      , Hh^Fms      , Hh^Fms      , Hh^Fms      , Hh^Fms      
Wwt         , Wwt         , Wot         , Wot         , Wot         , Wot         , Wot         , Wot         , Wot         , Wot         , Wot         , Wot         , Wot         , Wot         , Wot         , Wot         , Wot         , Wot         , Wot         , Wot         , Wot         , Wot         , Wot         , Wot         , Wot         , Wot         , Wot         , Wot         , Wot         , Ds          , Gs^Fms      , Gs^Fms      , Gs^Fms      , Gs^Fms      , Gs^Fms      , Gs^Fms      , Hh^Fms      , Hh          , Hh          , Hh          , Hh          
Wot         , Wot         , Wot         , Wot         , Wot         , Wot         , Wot         , Wot         , Wot         , Wot         , Wot         , Wot         , Wot         , Wot         , Wot         , Wot         , Wot         , Wot         , Wot         , Wot         , Wot         , Wot         , Wot         , Wot         , Wot         , Wot         , Wot         , Wot         , Wot         , Ds          , Gs^Fms      , Gs^Fms      , Gs^Fms      , Gs^Fms      , Gs^Fms      , Hh^Fms      , Hh          , Hh          , Hh          , Hh          , Hh          
Wot         , Wot         , Wot         , Wot         , Wot         , Wot         , Wot         , Wot         , Wot         , Wot         , Wot         , Wot         , Wot         , Wot         , Wot         , Wot         , Wot         , Wot         , Wot         , Wot         , Wot         , Wot         , Wot         , Wot         , Wot         , Wot         , Wot         , Wot         , Wot         , Ds          , Gs^Fms      , Gs^Fms      , Gs^Fms      , Gs^Fms      , Gs^Fms      , Hh^Fms      , Hh          , Hh          , Hh          , Hh          , Hh          
