border_size=1
usage=map

Gs          , Gs          , Gs^Fms      , Rd          , Gs          , Gs^Fms      , Wwt         , Wwt         , Wwt         , Wwt         , Gs          , Gs          , Gs^Fms      , Gs^Fms      , Gs^Fms      , Gs^Fms      , Gs          , Rd          , Gs          , Gs          , Gs^Fms      , Gs^Fms      , Gs^Fms      , Gs^Fms      , Gs^Fms      , Gs^Fms      , Gs^Fms      , Gs^Fms      , Gs^Fms      , Gs^Fms      , Gs^Fms      , Gs^Fms      , Gs^Fms      , Rd          , Gs^Fms      , Hh^Fp       , Gs^Fms      , Hh^Fms      , Md          , Mm^Xm       , Md          , Md          , Md^Xm       , Md          , Md          , Wot         , Wot         , Wot         , Wot         , Wot         , Wot         , Wot         , Wot         , Wot         , Wot         , Wot         , Wot         , Wot         , Wot         , Wot         , Wot         , Wot         
Gs          , Gs^Fms      , Gs^Fms      , Rd          , Gs^Fms      , Gs          , Wwt         , Wwt         , Wwt         , Wwt         , Gs^Fms      , Gs^Fms      , Gs^Fms      , Gs^Fms      , Gs^Fms      , Gs^Fms      , Gs^Fms      , Rd          , Gs^Fms      , Gs^Fms      , Gs^Fms      , Gs^Fms      , Gs^Fms      , Gs^Fms      , Gs^Fms      , Gs^Fms      , Gs^Fms      , Gs^Fms      , Gs^Fms      , Gs^Fms      , Gs^Fms      , Gs^Fms      , Gs          , Rd          , Gs^Fms      , Gs^Fms      , Gs^Vct      , Hh^Fms      , Md          , Md          , Md          , Md          , Md          , Md^Xm       , Md          , Wot         , Wot         , Wot         , Wot         , Wot         , Wot         , Wot         , Wot         , Wot         , Wot         , Wot         , Wot         , Wot         , Wot         , Wot         , Wot         , Wot         
Gs^Fms      , Gs^Fms      , Gs^Fms      , Rd          , Rd          , Gs^Fms      , Wwt         , Wwt         , Wwt         , Wwt         , Gs^Fms      , Gs^Fms      , Rd          , Rd          , Rd          , Rd          , Rd          , Rd          , Gs^Fms      , Gs^Fms      , Gs^Fms      , Gs^Fms      , Gs          , Gs^Fms      , Gs^Fms      , Gs          , Rd          , Gs          , Gs^Fms      , Gs^Fms      , Gs^Fms      , Gs^Fms      , Rd          , Rd          , Gs^Fms      , Gs^Fms      , Gs^Fms      , Hh^Fms      , Md          , Md          , Md          , Md          , Md          , Md          , Md          , Md          , Wot         , Wot         , Wot         , Wot         , Wot         , Wot         , Wot         , Wot         , Wot         , Wot         , Wot         , Wot         , Wot         , Wot         , Wot         , Wot         
Gs^Fms      , Gs^Fms      , Gs^Fms      , Gs^Fms      , Rd          , Gs^Fms      , Gs^Fms      , Wwt         , Wwt         , Gs          , Gs^Fms      , Rd          , Gs          , Gs^Fms      , Gs^Fms      , Gs^Fms      , Gs^Fms      , Gs^Fms      , Rd          , Gs^Fms      , Gs^Fms      , Gs          , Rd          , Rd          , Rd          , Rd          , Gs^Es       , Rd          , Rd          , Rd          , Rd          , Rd          , Gs^Es       , Gs^Fms      , Gs          , Gs^Efm      , Gs          , Gs          , Gs^Em       , Md          , Rd          , Md          , Md          , Md          , Mm^Xm       , Md          , Wot         , Wot         , Wot         , Wot         , Wot         , Wot         , Wot         , Wot         , Wot         , Wot         , Wot         , Wot         , Wot         , Wot         , Wot         , Wot         
Gs^Fms      , Gs^Fms      , Gs^Fms      , Gs^Fms      , Gs^Fms      , Rd          , Gs^Fms      , Wwt         , Gs          , Gs^Fms      , Gs^Fms      , Rd          , Gs^Fms      , Gs^Fms      , Gs          , Gs          , Rd          , Rd          , Gs^Efm      , Rd          , Rd          , Rd          , Gs          , Gs          , Gs          , Gs          , Gs          , Gs          , Gs          , Gs          , Gs          , Gs          , Gs          , Gs          , Gs          , Gs          , Gs          , Gs          , Rd          , Rd          , Gs^Es       , Md          , Md          , Md          , Md          , Md          , Wot         , Wot         , Wot         , Wot         , Wot         , Wot         , Wot         , Wot         , Wot         , Wot         , Wot         , Wot         , Wot         , Wot         , Wot         , Wot         
Gs^Fms      , Gs^Fms      , Gs^Fms      , Gs^Fms      , Gs^Fms      , Rd          , Gs^Fms      , Gs^Fms      , Gs^Fms      , Gs^Fms      , Rd          , Rd          , Gs^Fms      , Gs^Fms      , Gs^Fms      , Rd          , Gs          , Gs          , Gs          , Gs          , Gs          , Gs          , Gs          , Gs          , Gs          , Gs          , Gs          , Gs          , Gs          , Gs          , Gs          , Gs          , Gs          , Gs          , Gs          , Gs          , Gs          , Gs          , Rd          , Gs          , Gs^Fms      , Hh^Fms      , Hh^Fms      , Md          , Wwt         , Wwt         , Wot         , Wot         , Wot         , Wot         , Wot         , Wot         , Wot         , Wot         , Wot         , Wot         , Wot         , Wot         , Wot         , Wot         , Wot         , Wot         
Gs^Fms      , Gs^Fms      , Gs^Fms      , Gs^Fms      , Rd          , Rd          , Gs          , Gs^Efm      , Gs^Fms      , Gs^Fms      , Rd          , Gs^Fms      , Gs          , Gs          , Rd          , Rd          , Gs          , Gs          , Gs          , Gs          , Gs          , Gs^Es       , Rd          , Gs          , Rd          , Gs          , Gs^Efm      , Gs          , Gs^Fms      , Gg^Efm      , Gs^Fms      , Gs          , Gs          , Gs          , Rd          , Rd          , Rd          , Rd          , Gs          , Gs          , Gs          , Gs^Fms      , Gs^Fms      , Ds^Es       , Wwt         , Wwt         , Wwt         , Wot         , Wot         , Wot         , Wot         , Wot         , Wot         , Wot         , Wot         , Wot         , Wot         , Wot         , Wot         , Wot         , Wot         , Wot         
Gs^Fms      , Gs^Fms      , Gs^Fms      , Rd          , Gs^Fms      , Gs^Fms      , Gs^Fms      , Gs          , Rd          , Rd          , Gs^Efm      , Gs^Fms      , Rd          , Rd          , Gs          , Gs          , Gs          , Gs          , Gs          , Gs          , Gs          , Rd          , Gs^Fms      , Rd          , Gs^Fms      , Rd          , Rd          , Rd          , Rd          , Gs^Fms      , Rd          , Gs^Fms      , Rd          , Rd          , Gs          , Gs^Efm      , Gs          , Gs          , Gs          , Gs          , Gs          , Gs^Fms      , Gs^Fms      , Ds^Esd      , Ds          , Wwt         , Wwt         , Wwt         , Wwt         , Wot         , Wot         , Wot         , Wot         , Wot         , Wot         , Wot         , Wot         , Wot         , Wot         , Wot         , Wot         , Wot         
Gs^Fms      , Gs^Fms      , Gs^Fms      , Rd          , Gs^Fms      , Gs^Fms      , Gs^Fms      , Gs^Fms      , Rd          , Gs          , Gs          , Gs          , Rd          , Gs          , Gs          , Gs          , Gs          , Gs          , Gs          , Gs          , Rd          , Rd          , Gs^Fms      , Gs^Fms      , Hh^Fms      , Gs^Fms      , Gs^Fms      , Gs^Fms      , Gs^Fms      , Rd          , Gs^Fms      , Rd          , Gs          , Gs^Fms      , Gs          , Gs          , Gs          , Gs          , Gs          , Gs          , Gs          , Gs          , Gs^Fms      , Gs^Fms      , Gs          , Ds          , Ds^Es       , Wwt         , Wwt         , Wot         , Wot         , Wot         , Wot         , Wot         , Wot         , Wot         , Wot         , Wot         , Wot         , Wot         , Wot         , Wot         
Gs^Fms      , Gs^Fms      , Gs^Fms      , Rd          , Rd          , Gs^Efm      , Rd          , Rd          , Gs          , Gs          , Gs          , Gs^Es       , Rd          , Gs          , Gs          , Gs          , Gs          , Gs          , Gs          , Gs^Fms      , Rd          , Gs^Fms      , Gs^Fms      , Hh^Fms      , Hh          , Hh^Fms      , Hh^Fms      , Hh^Fms      , Hh^Fms      , Gs^Fms      , Gs^Fms      , Gs^Fms      , Gs^Fms      , Gs^Fms      , Gs          , Gs          , Gs          , Gs          , Gs          , Gs          , Gs          , Gs          , Gs^Fms      , Gs^Fms      , Gs^Fms      , Ds          , Ds          , Wwt         , Wwt         , Wwt         , Wot         , Wot         , Wot         , Wot         , Wot         , Wot         , Wot         , Wot         , Wot         , Wot         , Wot         , Wot         
Gs^Fms      , Gs          , Gs^Fms      , Gs^Es       , Rd          , Gs          , Rd          , Gs          , Rd          , Rd          , Rd          , Rd          , Gs          , Gs          , Gs          , Gs          , Gs          , Gs          , Gs^Fms      , Rd          , Gs^Fms      , Gs^Fms      , Hh^Fms      , Hh^Fms      , Hh          , Hh          , Hh          , Hh          , Hh          , Gg^Efm      , Gs^Fms      , Gs^Fms      , Gs^Fms      , Gs^Fms      , Gs^Fms      , Gs^Fms      , Gs          , Gs          , Gs          , Gs          , Gs          , Gs          , Gs^Efm      , Gs^Fms      , Gs^Fms      , Ds^Esd      , Ds          , Wwt         , Wwt         , Wwt         , Wot         , Wot         , Wot         , Wot         , Wot         , Wot         , Wot         , Wot         , Wot         , Wot         , Wot         , Wot         
Rd          , Rd          , Rd          , Gs          , Rd          , Gs          , Ce          , Gs          , Rd          , Gs^Efm      , Gs          , Gs          , Gs          , Gs          , Rd          , Gs^Efm      , Rd          , Gs^Fms      , Rd          , Rd          , Gs^Fms      , Hh^Fms      , Hh          , Hh          , Hh          , Hh          , Hh^Fms      , Hh          , Hh^Es       , Hh          , Gs          , Gs^Fms      , Gs^Fms      , Gs^Fms      , Gs^Fms      , Gs          , Gs^Efm      , Gs          , Gs          , Gs          , Gs          , Gs          , Gs^Fms      , Gs^Fms      , Gs          , Ds^Esd      , Ds          , Wwt         , Wwt         , Wot         , Wot         , Wot         , Wot         , Wot         , Wot         , Wot         , Wot         , Wot         , Wot         , Wot         , Wot         , Wot         
Gs^Fms      , Gs^Fms      , Rd          , Gs          , Ce          , Ce          , Chr         , Ce          , Ce          , Gs          , Rd          , Rd          , Rd          , Rd          , Gs^Efm      , Rd          , Gs          , Rd          , Gs^Fms      , Gs^Fms      , Gs^Fms      , Hh^Fms      , Hh          , Hh^Es       , Hh          , Hh          , Hh          , Hh          , Hh          , Hh          , Gs          , Gs^Efm      , Gs^Fms      , Gs^Fms      , Gs^Fms      , Gs^Fms      , Gs          , Gs          , Gs          , Gs          , Gs          , Gs^Em       , Gs          , Gs^Fms      , Gs^Fms      , Ds^Esd      , Ds          , Wwt         , Wwt         , Wot         , Wot         , Wot         , Wot         , Wot         , Wot         , Wot         , Wot         , Wot         , Wot         , Wot         , Wot         , Wot         
Gs^Efm      , Gs          , Gs          , Rd          , Ce          , Chr         , Ket         , Chr         , Ce          , Rd          , Gs          , Gs^Vwm      , Gs          , Gs          , Gs          , Gs          , Gs^Efm      , Gs^Fms      , Gs^Fms      , Gs^Fms      , Hh^Fms      , Hh^Fms      , Hh          , Hh          , Hh          , Hh          , Hh          , Hh          , Hh          , Hh          , Gs          , Gs          , Gs^Fms      , Gs^Fms      , Gs^Fms      , Gs^Fms      , Gs^Fms      , Gs          , Gs          , Gs          , Gs          , Gs^Fms      , Gs^Fms      , Gs^Fms      , Gs^Fms      , Ds          , Ds          , Wwt         , Wwt         , Wwt         , Wot         , Wot         , Wot         , Wot         , Wot         , Wot         , Wot         , Wot         , Wot         , Wot         , Wot         , Wot         
Gs          , Gs          , Gs          , Gs^Efm      , Ce          , Chr         , Ce          , Chr         , Ce          , Gs          , Gs          , Gs          , Gs          , Gs          , Gs          , Gs^Fms      , Gs^Fms      , Gs^Fms      , Gs^Fms      , Gs^Fms      , Hh^Fms      , Hh          , Hh          , Hh          , Hh^Fms      , Hh          , Hh          , Hh^Es       , Hh          , Hh          , Gs          , Gs^Efm      , Gs^Fms      , Gs^Fms      , Gs^Fms      , Gs          , Gs          , Gs          , Gs          , Gs          , Gs          , Gs^Fms      , Gs^Fms      , Gs^Fms      , Gs          , Ds^Es       , Ds          , Ds^Es       , Wwt         , Wwt         , Wot         , Wot         , Wot         , Wot         , Wot         , Wot         , Wot         , Wot         , Wot         , Wot         , Wot         , Wot         
Gs          , Gs          , Gs^Fms      , Rd          , Gs          , Ce          , Gs^Es       , Ce          , Gs          , Rd          , Gs^Efm      , Gs          , Gs          , Gs          , Gs          , Gs          , Gs          , Gs^Efm      , Gs^Fms      , Gs^Fms      , Hh^Fms      , Hh          , Hh          , Hh          , Hh          , Hh          , Hh^Es       , Hh          , Hh          , Hh^Fms      , Gs^Fms      , Gs^Fms      , Gs^Fms      , Gs^Fms      , Gs          , Gs^Fms      , Gs          , Gs          , Gs          , Gs          , Gs          , Gs^Em       , Gs          , Gs^Fms      , Gs^Fms      , Gs^Fms      , Ds^Esd      , Ds          , Wwt         , Wwt         , Wwt         , Wot         , Wot         , Wot         , Wot         , Wot         , Wot         , Wot         , Wot         , Wot         , Wot         , Wot         
Gs^Fms      , Gs^Fms      , Rd          , Rd          , Gs          , Rd          , Gs          , Rd          , Gs          , Rd          , Rd          , Gs          , Gs          , Gs          , Gs^Fms      , Gs          , Gs^Fms      , Gs^Fms      , Gs^Fms      , Gs^Fms      , Hh^Fms      , Hh          , Hh^Fms      , Hh          , Hh          , Hh          , Hh          , Hh          , Hh          , Hh^Fms      , Gs^Fms      , Gs^Fms      , Gs^Fms      , Gs^Fms      , Gs^Fms      , Gs          , Gs          , Gs          , Gs          , Gs          , Gs          , Gs          , Gs^Fms      , Gs^Fms      , Gs^Fms      , Gs^Fms      , Ds^Esd      , Ds          , Ds          , Wwt         , Wwt         , Wwt         , Wot         , Wot         , Wot         , Wot         , Wot         , Wot         , Wot         , Wot         , Wot         , Wot         
Gs^Fms      , Gs^Fms      , Rd          , Gs          , Rd          , Rd          , Gs^Efm      , Rd          , Rd          , Gs          , Gs^Efm      , Rd          , Gs          , Gg^Em       , Gs^Fms      , Gs^Fms      , Gs^Fms      , Gs^Fms      , Gs^Fms      , Gs^Fms      , Hh^Fms      , Hh          , Hh          , Hh          , Hh          , Hh^Fms      , Hh          , Hh          , Hh^Fms      , Hh^Fms      , Gs^Fms      , Gs^Fms      , Gs^Fms      , Gs^Fms      , Gg^Efm      , Gs          , Gs          , Gs          , Gs          , Gs          , Gs          , Gs          , Gs          , Gs^Fms      , Gs^Fms      , Gs^Fms      , Gs          , Ds^Esd      , Ds          , Ds^Es       , Wwt         , Wwt         , Wot         , Wot         , Wot         , Wot         , Wot         , Wot         , Wot         , Wot         , Wot         , Wot         
Rd          , Rd          , Gs          , Gs^Es       , Rd          , Gs^Fms      , Gs^Fms      , Gs^Fms      , Rd          , Gs          , Gs          , Rd          , Rd          , Rd          , Rd          , Rd          , Rd          , Gs^Fms      , Rd          , Gs^Fms      , Gs^Fms      , Hh^Fms      , Hh          , Hh          , Hh^Es       , Hh          , Hh          , Hh          , Hh^Fms      , Gs^Fms      , Gs^Fms      , Gs^Fms      , Gs^Fms      , Gs          , Gs          , Gs          , Gs          , Gs          , Gs          , Gs          , Gs          , Gs          , Gs          , Gs          , Gs^Fms      , Gs^Fms      , Gs^Fms      , Gs          , Ds          , Ds          , Wwt         , Wwt         , Wot         , Wot         , Wot         , Wot         , Wot         , Wot         , Wot         , Wot         , Wot         , Wot         
Gg^Em       , Gs          , Gs          , Gs          , Gs          , Rd          , Rd          , Gs^Fms      , Gs^Fms      , Rd          , Rd          , Gs          , Gs^Em       , Gs^Fms      , Gs^Fms      , Gs^Fms      , Gs^Fms      , Rd          , Gs^Fms      , Rd          , Gs          , Hh^Fms      , Hh^Fms      , Hh          , Hh          , Hh          , Hh^Fms      , Hh          , Gs          , Gs^Fms      , Gs          , Gs          , Gs^Efm      , Gs          , Gs          , Gs          , Gs          , Gs          , Gs          , Gs          , Gs          , Gs          , Gs          , Gs^Fms      , Gs^Fms      , Gs^Fms      , Gs^Fms      , Gs^Fms      , Ds          , Ds          , Wwt         , Wwt         , Wot         , Wot         , Wot         , Wot         , Wot         , Wot         , Wot         , Wot         , Wot         , Wot         
Gg^Em       , Gs          , Gs          , Gs          , Gs          , Gs^Es       , Rd          , Gs          , Gs^Fms      , Gs^Efm      , Gs          , Rd          , Gs^Fms      , Gs^Fms      , Gs^Fms      , Gs^Fms      , Ss^Em       , Gs^Fms      , Gs          , Rd          , Rd          , Gs^Fms      , Gs          , Hh^Fms      , Hh^Fms      , Hh^Fms      , Gs^Fms      , Hh^Fms      , Gs^Fms      , Gs^Fms      , Gs          , Gs          , Gs^Fms      , Gs          , Gs          , Gs          , Gs          , Gs          , Gs          , Gs          , Gs          , Gs          , Gs          , Gs          , Gs^Fms      , Gs^Fms      , Gs^Fms      , Ds^Esd      , Ds          , Ds^Es       , Wwt         , Wwt         , Wot         , Wot         , Wot         , Wot         , Wot         , Wot         , Wot         , Wot         , Wot         , Wot         
Gs^Fms      , Gs^Fms      , Gs          , Gs          , Gs          , Gs^Fms      , Rd          , Gs^Fms      , Gs^Fms      , Gs^Fms      , Gs          , Rd          , Gs^Fms      , Gs^Efm      , Gs^Fms      , Gs^Fms      , Ss          , Ss          , Ss          , Gs^Fms      , Gs^Fms      , Rd          , Rd          , Gs^Fms      , Gs^Fms      , Gs^Fms      , Rd          , Gs^Fms      , Rd          , Rd          , Rd          , Rd          , Rd          , Rd          , Rd          , Gs          , Gs          , Gs          , Gs          , Gs          , Gs          , Gs          , Gs^Efm      , Gs^Fms      , Gs^Fms      , Gs^Fms      , Gs          , Ds^Esd      , Ds          , Wwt         , Wwt         , Wwt         , Wot         , Wot         , Wot         , Wot         , Wot         , Wot         , Wot         , Wot         , Wot         , Wot         
Gs          , Gs          , Gs^Fms      , Gs^Fms      , Gs^Fms      , Rd          , Gs^Fms      , Gs^Efm      , Gs          , Gs          , Gs^Efm      , Rd          , Rd          , Gs          , Gs^Fms      , Gs^Fms      , Ss^Em       , Ss^Em       , Ss          , Ss^Em       , Gs          , Gs^Em       , Gs          , Rd          , Rd          , Rd          , Gs          , Rd          , Gs^Fms      , Gs^Fms      , Gs^Fms      , Gs^Fms      , Gs^Fms      , Gs^Fms      , Gs^Fms      , Rd          , Gs^Fms      , Gs          , Gs          , Gs          , Gs          , Gs          , Gs^Fms      , Gs^Fms      , Gs          , Gs^Fms      , Ds^Esd      , Ds          , Ds^Es       , Wwt         , Wwt         , Wot         , Wot         , Wot         , Wot         , Wot         , Wot         , Wot         , Wot         , Wot         , Wot         , Wot         
Gs^Fms      , Gs^Fms      , Gs^Fms      , Gs^Fms      , Gs          , Rd          , Gs          , Gs^Fms      , Gs^Fms      , Gs^Fms      , Gs          , Gs^Fms      , Gs^Fms      , Rd          , Gs          , Gs          , Gs^Fms      , Ss          , Ss^Em       , Ss          , Ss^Em       , Gs^Fms      , Gs^Fms      , Gs          , Gs          , Gs          , Gs          , Gs^Efm      , Gs^Fms      , Gs          , Wwt         , Wwt         , Wwt         , Wwt         , Gs          , Rd          , Rd          , Gs^Efm      , Gs          , Gs          , Gs          , Gs          , Gs          , Gs^Fms      , Gs^Fms      , Ds^Esd      , Ds          , Ds          , Wwt         , Wwt         , Wwt         , Wot         , Wot         , Wot         , Wot         , Wot         , Wot         , Wot         , Wot         , Wot         , Wot         , Wot         
Gs^Fms      , Gs^Fms      , Gs          , Gs^Fms      , Rd          , Rd          , Gs          , Gs^Fms      , Gs^Fms      , Gs^Fms      , Gs^Fms      , Gs^Fms      , Gs          , Rd          , Gs^Em       , Gs^Fms      , Gs^Fms      , Ss          , Ss          , Ss          , Gs          , Gs^Fms      , Gs^Fms      , Gs^Es       , Gs          , Gs          , Gs          , Gs^Fms      , Gs^Fms      , Wwt         , Gs          , Wwt         , Wwt         , Wwt         , Wwt         , Gs^Fms      , Gs^Fms      , Rd          , Gs          , Gs          , Gs          , Gs          , Gs^Fms      , Gs^Fms      , Gs          , Ds          , Ds          , Wwt         , Wwt         , Wwt         , Wot         , Wot         , Wot         , Wot         , Wot         , Wot         , Wot         , Wot         , Wot         , Wot         , Wot         , Wot         
Gs^Efm      , Gs          , Gs          , Rd          , Gs^Fms      , Gs          , Gs^Fms      , Gs^Fms      , Gs^Fms      , Gs^Fms      , Gs^Fms      , Gs^Fms      , Gs          , Rd          , Gs^Fms      , Gs^Fms      , Ss^Em       , Ss          , Ss          , Ss^Em       , Gs^Fms      , Gs^Fms      , Gs^Fms      , Gs^Fms      , Gs^Fms      , Gs^Fms      , Ss^Em       , Ss          , Gs^Fms      , Gs^Fms      , Gs^Fms      , Gs^Fms      , Wwt         , Ww^Vm       , Wwt         , Wwt         , Gs^Fms      , Rd          , Gs          , Gs          , Gs          , Gs^Efm      , Gs^Fms      , Gs          , Ds^Esd      , Ds          , Ds^Es       , Wwt         , Wwt         , Wot         , Wot         , Wot         , Wot         , Wot         , Wot         , Wot         , Wot         , Wot         , Wot         , Wot         , Wot         , Wot         
Gs^Fms      , Gs^Fms      , Rd          , Rd          , Gs^Fms      , Gs^Fms      , Gs^Fms      , Gs^Fms      , Gs^Fms      , Gs^Fms      , Gs^Fms      , Gs^Fms      , Gs^Fms      , Rd          , Rd          , Gs^Fms      , Gs^Fms      , Ss          , Ss^Em       , Gs          , Gs^Fms      , Gs^Fms      , Gs          , Gs^Fms      , Gs^Fms      , Gs          , Ss          , Ss          , Ss          , Gs^Fms      , Gs^Fms      , Gs^Fms      , Gs^Fms      , Wwt         , Wwt         , Gs          , Gs^Fms      , Rd          , Rd          , Gs          , Gs^Fms      , Gs          , Gs^Fms      , Ds^Esd      , Ds          , Ds          , Wwt         , Wwt         , Wwt         , Wot         , Wot         , Wot         , Wot         , Wot         , Wot         , Wot         , Wot         , Wot         , Wot         , Wot         , Wot         , Wot         
Gs^Efm      , Gs          , Rd          , Gs^Fms      , Gs          , Gs^Fms      , Gs^Fms      , Gs^Fms      , Gs^Fms      , Gs^Fms      , Gs^Fms      , Gs^Fms      , Gs^Fms      , Gs          , Rd          , Gs^Fms      , Gs^Fms      , Gs^Fms      , Gs^Fms      , Gs^Fms      , Gs^Fms      , Gs^Fms      , Gs          , Gs          , Gs^Fms      , Gs^Fms      , Gs          , Ss          , Ss          , Ss^Em       , Gs^Fms      , Gs^Fms      , Gs^Fms      , Gs          , Wwt         , Gs^Fms      , Gs^Efm      , Gs          , Rd          , Gs          , Gs^Fms      , Gs^Fms      , Gs^Fms      , Ds          , Ds^Es       , Wwt         , Wwt         , Wwt         , Wot         , Wot         , Wot         , Wot         , Wot         , Wot         , Wot         , Wot         , Wot         , Wot         , Wot         , Wot         , Wot         , Wot         
Gs^Efm      , Gs          , Rd          , Gs          , Gs          , Gs          , Gs          , Gs^Fms      , Gs^Fms      , Gs^Fms      , Gs^Fms      , Gs^Fms      , Gs          , Gs          , Rd          , Gs          , Gs^Fms      , Gs^Fms      , Gs^Fms      , Gs^Fms      , Gs^Fms      , Gs          , Gs          , Gs          , Gs          , Gs^Fms      , Gs^Fms      , Ss^Em       , Ss          , Ss          , Gs^Fms      , Gs^Fms      , Gs^Fms      , Gs^Fms      , Wwt         , Gs^Fms      , Gs          , Gs          , Rd          , Gs          , Gs          , Gs^Fms      , Gs          , Ds^Esd      , Ds          , Wwt         , Wwt         , Wwt         , Wot         , Wot         , Wot         , Wot         , Wot         , Wot         , Wot         , Wot         , Wot         , Wot         , Wot         , Wot         , Wot         , Wot         
